{
    "type":"map",
    "cols": 65,
    "rows": 11,
    "totalLayers": 3,
    "tSize": 64,
    "playerLayer": 2,

"tiles" : [

[1,	1,	1,	1,	1,	1,	1,	1,	1,	1,	1,	1,	1,	1,	1,	1,	1,	1,	1,	1,	1,	1,	1,	1,	1,	1,	1,	1,	1,	1,	1,	1,	1,	1,	1,	1,	1,	1,	1,	1,	1,	1,	1,	1,	1,	1,	1,	1,	1,	1,	1,	1,	1,	1,	1,	1,	1,	1,	1,	1,	1,	1,	1,	1,	1],
[1,	1,	1,	1,	1,	1,	1,	1,	1,	1,	1,	1,	1,	1,	1,	1,	1,	1,	1,	1,	1,	1,	1,	1,	1,	1,	1,	1,	1,	1,	1,	1,	1,	1,	1,	1,	1,	1,	0,	1,	1,	1,	1,	1,	1,	0,	0,	0,	0,	0,	0,	0,	0,	0,	0,	1,	1,	1,	1,	1,	1,	1,	1,	1,	1],
[1,	1,	1,	1,	1,	1,	1,	1,	1,	1,	1,	1,	1,	1,	1,	1,	1,	1,	1,	1,	1,	1,	1,	1,	0,	0,	1,	1,	0,	0,	0,	0,	1,	1,	1,	1,	1,	1,	0,	0,	0,	0,	0,	1,	1,	1,	1,	1,	1,	1,	1,	1,	1,	1,	0,	1,	0,	0,	0,	1,	0,	1,	1,	1,	1],
[1,	1,	1,	1,	1,	1,	1,	1,	1,	1,	1,	1,	1,	1,	0,	0,	0,	0,	0,	0,	1,	1,	1,	0,	0,	0,	0,	1,	0,	1,	1,	0,	1,	1,	1,	1,	1,	1,	1,	1,	1,	1,	0,	0,	0,	1,	0,	0,	0,	0,	0,	0,	0,	1,	0,	1,	0,	1,	1,	0,	0,	0,	1,	1,	1],
[1,	0,	0,	0,	0,	0,	0,	0,	0,	0,	0,	0,	1,	1,	0,	0,	0,	0,	0,	1,	1,	1,	0,	0,	0,	0,	0,	0,	1,	1,	1,	0,	1,	1,	0,	0,	0,	0,	1,	1,	1,	1,	0,	0,	0,	1,	0,	0,	0,	0,	0,	0,	0,	1,	0,	0,	0,	1,	1,	0,	0,	0,	0,	1,	1],
[1,	0,	0,	0,	0,	0,	0,	0,	0,	0,	0,	0,	1,	0,	0,	0,	0,	0,	0,	1,	0,	0,	0,	0,	0,	0,	0,	0,	0,	1,	1,	0,	1,	1,	0,	0,	0,	0,	1,	1,	1,	1,	0,	0,	0,	1,	0,	0,	0,	0,	0,	0,	0,	1,	1,	1,	1,	1,	0,	0,	0,	0,	0,	1,	1],
[1,	1,	1,	1,	1,	1,	1,	1,	1,	1,	0,	0,	0,	0,	0,	0,	0,	0,	0,	1,	1,	1,	0,	1,	0,	0,	0,	0,	0,	0,	1,	0,	0,	0,	0,	0,	0,	0,	1,	0,	0,	0,	0,	0,	0,	0,	0,	0,	0,	0,	0,	0,	0,	1,	1,	1,	1,	0,	0,	0,	0,	0,	0,	1,	1],
[1,	1,	1,	1,	1,	1,	1,	1,	1,	1,	1,	0,	1,	1,	1,	1,	1,	1,	1,	1,	1,	1,	1,	1,	1,	1,	1,	1,	1,	0,	1,	0,	1,	1,	1,	1,	1,	0,	1,	0,	0,	0,	0,	0,	0,	0,	0,	0,	0,	0,	0,	0,	0,	0,	1,	1,	1,	0,	0,	0,	0,	0,	0,	1,	1],
[1,	1,	1,	1,	1,	1,	1,	1,	1,	1,	1,	1,	1,	1,	0,	0,	0,	1,	1,	1,	1,	1,	1,	0,	1,	0,	1,	1,	1,	0,	0,	0,	1,	1,	1,	1,	1,	0,	0,	0,	0,	1,	1,	1,	1,	1,	0,	0,	1,	0,	0,	0,	0,	0,	0,	0,	0,	0,	0,	0,	0,	0,	1,	0,	1],
[1,	1,	1,	1,	1,	1,	1,	1,	1,	1,	1,	1,	1,	1,	1,	1,	1,	1,	1,	1,	1,	1,	1,	1,	1,	1,	1,	1,	1,	1,	1,	1,	1,	1,	1,	1,	1,	1,	1,	1,	1,	1,	1,	1,	1,	1,	1,	1,	1,	1,	1,	1,	1,	1,	1,	1,	1,	1,	1,	1,	1,	1,	1,	1,	1],
[1,	1,	1,	1,	1,	1,	1,	1,	1,	1,	1,	1,	1,	1,	1,	1,	1,	1,	1,	1,	1,	1,	1,	1,	1,	1,	1,	1,	1,	1,	1,	1,	1,	1,	1,	1,	1,	1,	1,	1,	1,	1,	1,	1,	1,	1,	1,	1,	1,	1,	1,	1,	1,	1,	1,	1,	1,	1,	1,	1,	1,	1,	1,	1,	1]

],

"layers" :[[

[3,	3,	3,	3,	3,	3,	3,	3,	3,	3,	3,	3,	3,	3,	3,	3,	3,	3,	3,	3,	3,	3,	3,	3,	3,	3,	3,	3,	3,	3,	3,	3,	3,	3,	3,	3,	3,	3,	3,	3,	3,	3,	3,	3,	3,	3,	3,	3,	3,	3,	3,	3,	3,	3,	3,	3,	3,	3,	3,	3,	3,	3,	3,	3,	3],
[3,	3,	3,	3,	3,	3,	3,	3,	3,	3,	3,	3,	3,	3,	3,	3,	3,	3,	3,	3,	3,	3,	3,	3,	3,	3,	3,	3,	3,	3,	3,	3,	3,	3,	3,	3,	3,	3,	1,	3,	3,	3,	3,	3,	3,	1,	1,	1,	1,	1,	1,	1,	1,	1,	1,	3,	3,	3,	3,	3,	3,	3,	3,	3,	3],
[3,	3,	3,	3,	3,	3,	3,	3,	3,	3,	3,	3,	3,	3,	3,	3,	3,	3,	3,	3,	3,	3,	3,	3,	1,	1,	3,	3,	1,	1,	1,	1,	3,	3,	3,	3,	3,	3,	1,	1,	1,	1,	1,	3,	3,	3,	3,	3,	3,	3,	3,	3,	3,	3,	1,	3,	1,	1,	1,	1,	1,	3,	3,	3,	3],
[3,	3,	3,	3,	3,	3,	3,	3,	3,	3,	3,	3,	3,	3,	1,	1,	1,	1,	1,	1,	3,	3,	3,	1,	1,	1,	1,	3,	1,	3,	3,	1,	3,	3,	3,	3,	3,	3,	3,	3,	3,	3,	1,	1,	1,	3,	1,	1,	1,	1,	1,	1,	1,	3,	1,	3,	1,	3,	3,	1,	1,	1,	3,	3,	3],
[3,	1,	1,	1,	1,	1,	1,	1,	1,	1,	1,	1,	3,	3,	1,	1,	1,	1,	1,	1,	3,	3,	1,	1,	1,	1,	1,	1,	3,	3,	3,	1,	3,	3,	1,	1,	1,	1,	3,	3,	3,	3,	1,	1,	1,	3,	1,	1,	1,	1,	1,	1,	1,	3,	1,	1,	1,	3,	3,	1,	1,	1,	3,	3,	3],
[3,	1,	1,	1,	1,	1,	1,	1,	1,	1,	1,	1,	3,	1,	1,	1,	1,	1,	1,	1,	1,	1,	1,	1,	1,	1,	1,	1,	1,	3,	3,	1,	3,	3,	1,	1,	1,	1,	3,	3,	3,	3,	1,	1,	1,	3,	1,	1,	1,	1,	1,	1,	1,	3,	3,	3,	3,	3,	1,	1,	1,	1,	3,	3,	3],
[3,	3,	3,	3,	3,	3,	3,	3,	3,	3,	1,	1,	1,	1,	1,	1,	1,	1,	1,	1,	3,	3,	1,	3,	1,	1,	1,	1,	1,	1,	3,	1,	1,	1,	1,	1,	1,	1,	3,	1,	1,	1,	1,	1,	1,	1,	1,	1,	1,	1,	1,	1,	1,	3,	3,	3,	3,	1,	1,	1,	1,	1,	3,	3,	3],
[3,	3,	3,	3,	3,	3,	3,	3,	3,	3,	3,	1,	3,	3,	3,	1,	3,	3,	3,	3,	3,	3,	3,	3,	3,	3,	3,	3,	3,	1,	3,	1,	3,	3,	3,	3,	3,	1,	3,	1,	1,	1,	1,	1,	1,	1,	1,	1,	1,	1,	1,	1,	1,	1,	3,	3,	3,	1,	1,	1,	1,	1,	3,	3,	3],
[3,	3,	3,	3,	3,	3,	3,	3,	3,	3,	3,	3,	3,	3,	1,	1,	1,	3,	3,	3,	3,	3,	3,	1,	1,	1,	3,	3,	3,	1,	1,	1,	3,	3,	3,	3,	3,	1,	1,	1,	1,	3,	3,	3,	3,	3,	1,	1,	3,	1,	1,	1,	1,	1,	1,	1,	1,	1,	1,	1,	1,	1,	1,	1,	3],
[3,	3,	3,	3,	3,	3,	3,	3,	3,	3,	3,	3,	3,	3,	3,	1,	3,	3,	3,	3,	3,	3,	3,	3,	3,	3,	3,	3,	3,	3,	3,	3,	3,	3,	3,	3,	3,	3,	3,	3,	3,	3,	3,	3,	3,	3,	3,	3,	3,	3,	3,	3,	3,	3,	3,	3,	3,	3,	3,	3,	3,	3,	3,	3,	3],
[3,	3,	3,	3,	3,	3,	3,	3,	3,	3,	3,	3,	3,	3,	3,	3,	3,	3,	3,	3,	3,	3,	3,	3,	3,	3,	3,	3,	3,	3,	3,	3,	3,	3,	3,	3,	3,	3,	3,	3,	3,	3,	3,	3,	3,	3,	3,	3,	3,	3,	3,	3,	3,	3,	3,	3,	3,	3,	3,	3,	3,	3,	3,	3,	3]

],[

[0,	0,	0,	0,	0,	0,	0,	0,	0,	0,	0,	0,	0,	0,	0,	0,	0,	0,	0,	0,	0,	0,	0,	0,	0,	0,	0,	0,	0,	0,	0,	0,	0,	0,	0,	0,	0,	0,	0,	0,	0,	0,	0,	0,	0,	0,  0,	0,	0,	0,	0,	0,	0,	0,	0,	0,	0,	0,	0,	0,	0,	0,	0,	0,	0],
[0,	0,	0,	0,	0,	0,	0,	0,	0,	0,	0,	0,	0,	0,	0,	0,	0,	0,	0,	0,	0,	0,	0,	0,	0,	0,	0,	0,	0,	0,	0,	0,	0,	0,	0,	0,	0,	0,	0,	0,	0,	0,	0,	0,	0,	102,0,	0,	0,	0,	101,101,101	,0,	101,0,	0,	0,	0,	0,	0,	0,	0,	0,	0],
[0,	0,	0,	0,	0,	0,	0,	0,	0,	0,	0,	0,	0,	0,	0,	0,	0,	0,	0,	0,	0,	0,	0,	0,	0,	0,	0,	0,	1001,0,	0,	0,	0,	0,	0,	0,	0,	0,	0,	0,	0,	0,	0,	0,	0,  0,	0,	0,	0,	0,	0,	0,	0,	0,	0,	0,	0,	0,	0,	503,0,	0,	0,	0,	0],
[0,	0,	0,	0,	0,	0,	0,	0,	0,	0,	0,	0,	0,	0,	0,	0,	0,	0,	0,	0,	0,	0,	0,	0,	0,	0,	0,	0,	0,	0,	0,	0,	0,	0,	0,	0,	0,	0,	0,	0,	0,	0,	0,	0,	0,	0,	0,	0,	0,	0,	0,	0,	0,	0,	0,	0,	0,	0,	0,	0,	0,	0,	0,	0,	0],
[0,	0,	0,	0,	0,	0,	0,	0,	0,	0,	0,	0,  0,	0,	0,	0,	0,	101,0,	0,	0,	0,	0,	0,	0,	0,	0,	0,	0,	0,	0,	0,	0,	0,	0,	0,	0,	0,	0,	0,	0,	0,	0,	0,	0,	0,	0,	0,	0,	0,	0,	0,	0,	0,	0,	0,	0,	0,	0,	0,	0,	0,	0,	0,	0],
[0,	0,	0,	0,	0,	0,	101,0,	0,	0,	0,	0,  0,	0,	0,	0,	0,	0,	0,	502,0,	0,	0,	0,	0,	0,	0,	0,	0,	0,	0,	0,	0,	0,	0,	0,	101,0,	0,	0,	0,	0,	0,	0,	0,	0,	0,	0,	0,	0,	0,	0,	0,	0,	0,	0,	0,	0,	0,	0,	0,	0,	0,	0,	0],
[0,	0,	0,	0,	0,	0,	0,	0,	0,	101,0,	0,  0,	0,	0,	0,	0,	101,0,	0,	0,	0,	0,	0,	0,	0,	0,	0,	0,	0,	0,	0,	0,	0,	0,	0,	0,	0,	0,	0,	0,	0,	0,	0,	0,	0,	0,	0,	0,	0,	0,	0,	0,	0,	0,	0,	0,	0,	0,	0,	0,	0,	0,	0,	0],
[0,	0,	0,	0,	0,	0,	0,	0,	0,	0,	0,	0,	0,	0,	0,	501,0,	0,	0,	0,	0,	0,	0,	0,	0,  0,	0,	0,	0,	0,	0,	0,	0,	0,	0,	0,	0,	0,	0,	0,	0,	0,	0,	0,	0,	0,	0,	0,	0,	0,	0,	0,	0,	0,	0,	0,	0,	0,	0,	0,	0,	0,	0,	0,	0],
[0,	0,	0,	0,	0,	0,	0,	0,	0,	0,	0,	0,	0,	0,	0,	102,0,	0,	0,	0,	0,	0,	0,	0,	0,  0,	0,	0,	0,	0,	0,	0,	0,	0,	0,	0,	0,	0,	0,	0,	0,	0,	0,	0,	0,	0,	0,	0,	0,	0,	0,	0,	0,	0,	0,	0,	0,	0,	0,	0,	0,	0,	1002,99,0],
[0,	0,	0,	0,	0,	0,	0,	0,	0,	0,	0,	0,	0,	0,	0,	0,	0,	0,	0,	0,	0,	0,	0,	0,	0,	0,	0,	0,	0,	0,	0,	0,	0,	0,	0,	0,	0,	0,	0,	0,	0,	0,	0,	0,	0,	0,	0,	0,	0,	0,	0,	0,	0,	0,	0,	0,	0,	0,	0,	0,	0,	0,	0,	0,	0],
[0,	0,	0,	0,	0,	0,	0,	0,	0,	0,	0,	0,	0,	0,	0,	0,	0,	0,	0,	0,	0,	0,	0,	0,	0,	0,	0,	0,	0,	0,	0,	0,	0,	0,	0,	0,	0,	0,	0,	0,	0,	0,	0,	0,	0,	0,	0,	0,	0,	0,	0,	0,	0,	0,	0,	0,	0,	0,	0,	0,	0,	0,	0,	0,	0]

],[

[4,	4,	4,	4,	4,	4,	4,	4,	4,	4,	4,	4,	4,	4,	4,	4,	4,	4,	4,	4,	4,	4,	4,	4,	4,	4,	4,	4,	4,	4,	4,	4,	4,	4,	4,	4,	4,	4,	0,	4,	4,	4,	4,	4,	4,	0,	0,	0,	0,	0,	0,	0,	0,	0,	0,	4,	4,	4,	4,	4,	4,	4,	4,	4,	4],
[4,	4,	4,	4,	4,	4,	4,	4,	4,	4,	4,	4,	4,	4,	4,	4,	4,	4,	4,	4,	4,	4,	4,	4,	0,	0,	4,	4,	0,	0,	0,	0,	4,	4,	4,	4,	4,	4,	0,	0,	0,	0,	0,	4,	4,	4,	4,	4,	4,	4,	4,	4,	4,	4,	0,	4,	0,	0,	0,	0,  0,	4,	4,	4,	4],
[4,	4,	4,	4,	4,	4,	4,	4,	4,	4,	4,	4,	4,	4,	0,	0,	0,	0,	0,	0,	4,	4,	4,	0,	0,	0,	0,	4,	0,	4,	4,	0,	4,	4,	4,	4,	4,	4,	4,	4,	4,	4,	0,	0,	0,  4,	0,	0,	0,	0,	0,	0,	0,	4,	0,	4,	0,	4,	4,	155,0,	0,	4,	4,	4],
[4,	0,	0,	0,	0,	0,	0,	0,	0,	0,	0,  0,	4,	4,	0,	0,	0,	0,	0,	0,	4,	4,	0,	0,	0,	0,	0,	0,	4,	4,	4,	0,	4,	4,	0,	0,	0,	0,	4,	4,	4,	4,	0,	0,	0,	4,	0,	0,	0,	0,	0,	0,	0,	4,	0,	0,	0,	4,	4,	0,	0,	0,	4,	4,	4],
[4,	0,	0,	0,	0,	0,	0,	0,	0,	0,	0,	0,  4,	0,	0,	0,	0,	0,	0,	0,	0,	0,	0,	0,	0,	0,	0,	0,	0,	4,	4,	0,	4,	4,	0,	0,	0,	0,	4,	4,	4,	4,	0,	0,	0,	4,	0,	0,	0,	0,	0,	0,	0,	4,	4,	4,	4,	4,	0,	0,	0,	0,	4,	4,	4],
[4,	4,	4,	4,	4,	4,	4,	4,	4,	4,	0,	0,  0,	0,	0,	0,	0,	0,	0,	151,4,	4,	0,	4,	0,	0,	0,	0,	0,	0,	4,	0,	0,	0,	0,	0,	0,	0,	4,	0,	0,	0,	0,	0,	0,	0,	0,	0,	0,	0,	0,	0,	0,	4,	4,	4,	4,	0,	0,	0,	0,	0,	4,	4,	4],
[4,	4,	4,	4,	4,	4,	4,	4,	4,	4,	4,	0,  4,	4,	4,	0,	4,	4,	4,	4,	4,	4,	4,	4,	4,	4,	4,	4,	4,	0,	4,	0,	4,	4,	4,	4,	4,	0,	4,	0,	0,	0,	0,	0,	0,	0,	0,	0,	0,	0,	0,	0,	0,	0,	4,	4,	4,	0,	0,	0,	0,	0,	4,	4,	4],
[4,	4,	4,	4,	4,	4,	4,	4,	4,	4,	4,	4,	4,	4,	0,	155,0,	4,	4,	4,	4,	4,	4,	0,	0,	0,	4,	4,	4,	0,	0,	0,	4,	4,	4,	4,	4,	0,	0,	0,	0,	4,	4,	4,	4,	4,	0,	0,	4,	0,	0,	0,	0,	0,	0,	0,	0,	0,	0,	0,	0,	0,	0,	0,	4],
[4,	4,	4,	4,	4,	4,	4,	4,	4,	4,	4,	4,	4,	4,	4,	0,	4,	4,	4,	4,	4,	4,	4,	4,	4,	4,	4,	4,	4,	4,	4,	4,	4,	4,	4,	4,	4,	4,	4,	4,	4,	4,	4,	4,	4,	4,	4,	4,	4,	4,	4,	4,	4,	4,	4,	4,	4,	4,	4,	4,	4,	4,	4,	4,	4],
[4,	4,	4,	4,	4,	4,	4,	4,	4,	4,	4,	4,	4,	4,	4,	4,	4,	4,	4,	4,	4,	4,	4,	4,	4,	4,	4,	4,	4,	4,	4,	4,	4,	4,	4,	4,	4,	4,	4,	4,	4,	4,	4,	4,	4,	4,	4,	4,	4,	4,	4,	4,	4,	4,	4,	4,	4,	4,	4,	4,	4,	4,	4,	4,	4],
[4,	4,	4,	4,	4,	4,	4,	4,	4,	4,	4,	4,	4,	4,	4,	4,	4,	4,	4,	4,	4,	4,	4,	4,	4,	4,	4,	4,	4,	4,	4,	4,	4,	4,	4,	4,	4,	4,	4,	4,	4,	4,	4,	4,	4,	4,	4,	4,	4,	4,	4,	4,	4,	4,	4,	4,	4,	4,	4,	4,	4,	4,	4,	4,	4]

]


]
}