{
"type":"map",
"cols": 35,
"rows": 31,
"totalLayers": 2,
"tSize": 64,
"playerLayer": 1,

"tiles":
[
[1,	1,	1,	1,	1,	1,	1,	1,	1,	1,	1,	1,	1,	1,	1,	1,	1,	1,	1,	1,	1,	1,	1,	1,	1,	1,	1,	1,	1,	1,	1,	1,	1,	1,	1],	
[1,	1,	0,	0,	1,	1,	0,	1,	1,	1,	1,	0,	0,	1,	0,	0,	0,	0,	0,	1,	0,	1,	0,	1,	1,	1,	0,	1,	0,	0,	0,	1,	1,	1,	1],
[1,	1,	0,	1,	0,	0,	1,	1,	1,	0,	0,	0,	0,	0,	0,	1,	1,	0,	0,	0,	0,	0,	0,	0,	1,	0,	0,	1,	1,	0,	0,	0,	1,	1,	1],
[1,	0,	0,	0,	0,	1,	1,	1,	0,	0,	0,	0,	0,	0,	1,	0,	1,	0,	1,	0,	0,	0,	0,	0,	1,	1,	1,	1,	0,	0,	0,	0,	0,	1,	1],
[1,	0,	1,	0,	1,	1,	1,	1,	1,	1,	1,	1,	1,	0,	1,	0,	1,	0,	1,	0,	1,	0,	0,	0,	1,	1,	1,	1,	0,	0,	0,	0,	0,	1,	1],
[1,	0,	1,	0,	1,	1,	0,	0,	0,	0,	0,	0,	0,	0,	0,	0,	1,	0,	1,	0,	1,	0,	0,	0,	1,	0,	0,	0,	0,	0,	1,	1,	1,	1,	1],
[1,	0,	0,	0,	0,	1,	0,	0,	1,	0,	0,	0,	1,	1,	1,	0,	1,	0,	1,	0,	1,	0,	0,	0,	1,	0,	1,	0,	0,	0,	1,	1,	1,	1,	1],
[1,	0,	1,	1,	0,	1,	0,	1,	1,	0,	0,	0,	0,	0,	0,	0,	1,	0,	1,	0,	1,	0,	0,	0,	1,	1,	0,	0,	0,	0,	0,	0,	0,	1,	1],
[1,	1,	1,	1,	0,	1,	0,	1,	1,	1,	0,	0,	0,	0,	0,	1,	1,	1,	0,	1,	1,	1,	1,	1,	1,	0,	0,	0,	0,	0,	1,	1,	1,	1,	1],
[1,	1,	1,	1,	0,	0,	0,	1,	1,	0,	0,	1,	1,	0,	0,	0,	0,	1,	0,	0,	0,	0,	0,	0,	1,	0,	1,	1,	1,	0,	0,	0,	0,	1,	1],
[1,	1,	1,	1,	1,	0,	0,	1,	1,	1,	1,	1,	1,	1,	1,	1,	1,	1,	0,	0,	0,	0,	1,	0,	1,	0,	0,	0,	0,	0,	0,	0,	0,	1,	1],
[1,	1,	1,	1,	1,	1,	0,	0,	0,	0,	0,	1,	1,	1,	0,	1,	1,	1,	0,	0,	0,	0,	0,	0,	1,	0,	1,	1,	1,	1,	1,	0,	0,	1,	1],
[1,	0,	0,	0,	0,	0,	0,	0,	0,	0,	0,	0,	0,	0,	0,	0,	0,	0,	0,	0,	0,	0,	0,	0,	1,	0,	1,	1,	1,	1,	0,	0,	0,	1,	1],
[1,	1,	1,	1,	1,	1,	1,	1,	1,	1,	1,	0,	1,	0,	1,	1,	0,	1,	0,	1,	1,	1,	1,	0,	1,	0,	1,	0,	0,	0,	0,	1,	1,	1,	1],
[1,	1,	1,	1,	1,	1,	1,	1,	1,	1,	1,	1,	1,	1,	1,	1,	1,	1,	0,	1,	1,	1,	0,	0,	1,	0,	0,	0,	0,	0,	0,	1,	1,	1,	1],
[1,	1,	1,	1,	1,	1,	1,	1,	1,	1,	1,	1,	1,	1,	1,	1,	0,	0,	0,	1,	1,	0,	0,	0,	1,	0,	0,	1,	1,	0,	0,	1,	1,	1,	1],
[1,	1,	1,	0,	0,	0,	1,	1,	1,	1,	1,	1,	0,	1,	0,	0,	0,	1,	0,	1,	1,	0,	0,	0,	1,	0,	1,	1,	1,	0,	0,	1,	1,	1,	1],
[1,	0,	0,	0,	0,	0,	1,	1,	1,	1,	1,	0,	0,	1,	1,	0,	0,	1,	1,	1,	1,	0,	0,	0,	1,	1,	1,	0,	0,	0,	1,	1,	1,	1,	1],
[1,	0,	0,	0,	0,	0,	0,	0,	0,	1,	0,	0,	0,	1,	1,	1,	1,	1,	1,	0,	0,	1,	0,	0,	1,	1,	0,	0,	0,	0,	1,	1,	1,	1,	1],
[1,	0,	1,	0,	0,	0,	0,	1,	1,	1,	0,	1,	1,	1,	1,	1,	1,	1,	1,	0,	0,	1,	0,	0,	1,	0,	0,	1,	1,	1,	0,	0,	0,	1,	1],
[1,	0,	1,	1,	1,	1,	1,	1,	1,	1,	1,	1,	1,	1,	1,	1,	1,	1,	1,	0,	1,	1,	1,	0,	1,	0,	0,	1,	1,	1,	0,	1,	0,	1,	1],
[1,	0,	0,	0,	0,	1,	1,	0,	0,	1,	1,	1,	1,	1,	1,	0,	0,	0,	1,	0,	1,	1,	1,	0,	1,	1,	0,	0,	0,	1,	0,	1,	0,	1,	1],
[1,	0,	0,	0,	0,	0,	0,	0,	0,	1,	1,	1,	1,	1,	1,	0,	1,	0,	1,	0,	0,	1,	0,	0,	0,	1,	0,	0,	0,	1,	0,	1,	0,	1,	1],
[1,	1,	0,	0,	0,	0,	1,	0,	1,	1,	1,	1,	1,	1,	1,	0,	0,	1,	1,	1,	1,	0,	0,	1,	0,	1,	1,	0,	0,	1,	0,	1,	0,	1,	1],
[1,	1,	1,	0,	1,	1,	1,	0,	1,	0,	0,	0,	0,	1,	1,	0,	0,	1,	1,	1,	0,	0,	1,	1,	0,	1,	1,	0,	0,	0,	0,	1,	0,	1,	1],
[1,	1,	1,	0,	1,	1,	1,	1,	1,	0,	1,	1,	0,	1,	1,	0,	0,	0,	1,	0,	0,	1,	1,	1,	0,	1,	1,	1,	1, 	1,	1,	1,	0,	1,	1],
[1,	1,	1,	0,	1,	1,	1,	1,	1,	0,	0,	1,	0,	1,	1,	0,	0,	0,	0,	0,	1,	1,	1,	1,	1,	1,	1,	1,	1,	1,	1,	1,	0,	1,	1],
[1,	0,	0,	0,	0,	0,	0,	0,	0,	1,	0,	1,	0,	0,	1,	0,	0,	1,	0,	1,	1,	1,	1,	1,	0,	1,	0,	0,	0,	0,	0,	1,	0,	1,	1],
[1,	1,	1,	1,	1,	1,	1,	1,	0,	0,	0,	1,	1,	0,	0,	1,	1,	1,	1,	1,	1,	1,	1,	1,	0,	0,	0,	1,	1,	1,	0,	0,	0,	1,	1],
[1,	1,	1,	1,	1,	1,	0,	1,	1,	1,	1,	1,	1,	1,	1,	1,	1,	1,	1,	1,	1,	1,	1,	1,	1,	1,	1,	1,	1,	1,	1,	1,	1,	1, 	1],
[1,	1,	1,	1,	1,	1,	1,	1,	1,	1,	1,	1,	1,	1,	1,	1,	1,	1,	1,	1,	1,	1,	1,	1,	1,	1,	1,	1,	1,	1,	1,	1,	1,	1,	1]
],

"layers":
[[
[722, 722,	722,	722,	722,	722,	722,	722,	722,	722,	722,	722,	722,	722,	722,	722,	722,	722,	722,	722,	722,	722,	722,	722,	722,	722,	722,	722,	722,	722,	722,	722,	722,	722,	722],	
[722, 722,	721,	721,	722,	721,	721,    722,	722,	722,	722,	721,	721,	722,	721,	721,	721,	721,	721,	722,	721,	722,	721,	722,	722,	722,	721,	722,	721,	721,	721,	722,	722,	722,	722],
[722, 722,	721,	722,	721,	721,	722,	722,	722,	721,	721,	721,	721,	721,	721,	722,	722,	721,	721,	721,	721,	721,	721,	721,	202,    721,	721,	722,	722,	721,	721,	721,	722,	722,	722],
[722, 721,	721,	721,	721,	722,	722,	722,	721,	721,	721,	721,	721,	721,	722,	721,	722,	721,	722,	721,	721,	721,	721,	721,	722,	722,	722,	722,	721,	721,	721,	721,	721,	722,	722],
[722, 721,	722,	721,	722,	722,	722,	722,	722,	722,	722,	722,	722,	721,	722,	721,	722,	721,	722,	721,	722,	721,	721,	721,	722,	722,	722,	722,	721,	721,	721,	721,	721,	722,	722],
[722, 721,	722,	721,	722,	722,	721,	721,	721,	721,	721,	721,	721,	721,	721,	721,	722,	721,	722,	721,	722,	721,	721,	721,	722,	721,	721,	721,	721,	721,	722,	722,	722,	722,	722],
[722, 721,	721,	721,	721,	722,	721,	721,	722,	721,	721,	721,	722,	722,	722,	721,	722,	721,	722,	721,	722,	721,	721,	721,	722,	721,    722,	721,	721,	721,	722,	722,	722,	722,	722],
[722, 721,	722,	722,	721,	722,	721,	722,	722,	721,	721,	721,	721,	721,	721,	721,	722,	721,	722,	721,	722,	721,	721,	721,	722,	722,	721,	721,	721,	721,	721,	721,	721,	722,	722],
[722, 722,	722,	722,	721,	722,	721,	722,	722,	722,	721,	721,	721,	721,	721,	722,	722,	722,	721,	722,	722,	722,	722,	722,	722,	721,	721,	721,	721,	721,	722,	722,	722,	722,	722],
[722, 722,	722,	722,	721,	721,	721,	722,	722,	721,	721,	722,	722,	721,	721,	721,	721,	722,	721,	721,	721,	721,	721,	721,	722,	721,	722,	722,	722,	721,	721,	721,	721,	722,	722],
[722, 722,	722,	722,	722,	721,	721,	722,	722,	722,	722,	722,	722,	722,	722,	722,	722,	722,	721,	721,	721,	721,	722,	721,	722,	721,	721,	721,	721,	721,	721,	721,	721,	722,	722],
[722, 722,	722,	722,	722,	722,	721,	721,	721,	721,	721,	722,	722,	722,	721,	722,	722,	722,	721,	721,	721,	721,	721,	721,	722,	721,	722,	722,	722,	722,	722,	721,	721,	722,	722],
[722, 721,	721,	721,	721,	721,	721,	721,	721,	721,	721,	721,	721,	721,	721,	721,	721,	721,	721,	721,	721,	721,	721,	721,	722,	721,	722,	722,	722,	722,	721,	721,	721,	722,	722],
[722, 722,	722,	722,	722,	722,	722,	722,	722,	722,	722,	721,	722,	721,	722,	722,	721,	722,	721,	722,	722,	722,	722,	721,	722,	721,	722,	721,	721,	721,	721,	722,	722,	722,	722],
[722, 722,	722,	722,	722,	722,	722,	722,	722,	722,	722,	722,	722,	722,	722,	722,	722,	722,	721,	722,	722,	722,	721,	721,	722,	721,	721,	721,	721,	721,	721,	722,	722,	722,	722],
[722, 722,	722,	722,	722,	722,	722,	722,	722,	722,	722,	722,	722,	722,	722,	722,	721,	721,	721,	722,	722,	721,	721,	721,	722,	721,	721,	722,	722,	721,	721,	722,	722,	722,	722],
[722, 722,	722,	721,	721,	721,	722,	722,	722,	722,	722,	722,	721,	721,    721,	721,	721,	722,	721,	722,	722,	721,	721,	721,	722,	721,	722,	722,	722,	721,	721,	722,	722,	722,	722],
[722, 721,	721,	721,	721,	721,	722,	722,	722,	722,	722,	721,	721,	722,	722,	721,	721,	722,	722,	722,	722,	721,	721,	721,	722,	722,	722,	721,	721,	721,	722,	722,	722,	722,	722],
[722, 721,	721,	721,	721,	721,	721,	721,	721,	721,	721,	721,	721,	722,	722,	722,	722,	722,	722,	721,	721,	722,	721,	721,	722,	722,	721,	721,	721,	721,	722,	722,	722,	722,	722],
[722, 721,	722,	721,	721,	721,	721,	722,	722,	722,	721,	722,	722,	722,	722,	722,	722,	722,	722,	721,	721,    722,	721,	721,	722,	721,	721,	722,	722,	722,	721,	721,	721,	722,	722],
[722, 721,	722,	722,	722,	722,	722,	722,	722,	722,	722,	722,	722,	722,	722,	722,	722,	722,	722,	721,	722,	722,	722,	721,	722,	721,	721,	722,	722,	722,	721,	722,	721,	722,	722],
[722, 721,	721,	721,	721,	722,	722,	721,	721,	722,	722,	722,	722,	722,	722,	721,	721,	721,	722,	721,	722,	722,	722,	721,	722,	722,	721,	721,	721,	722,	721,	722,	721,	722,	722],
[722, 721,	721,	721,	721,	721,	721,	721,	721,	722,	722,	722,	722,	722,	722,	721,	722,	721,	722,	721,	721,	722,	721,	721,	721,	722,	721,	721,	721,	722,	721,	722,	721,	722,	722],
[722, 722,	721,	721,	721,	721,	722,	721,	722,	722,	722,	722,	722,	722,	722,	721,	721,	722,	722,	722,	721,	721,	721,	722,	721,	722,	722,	721,	721,	722,	721,	722,	721,	722,	722],
[722, 722,	722,	721,	722,	722,	722,	721,	722,	721,	721,	721,	721,	722,	722,	721,	721,	722,	722,	722,	721,	721,	722,	722,	721,	722,	722,	721,	721,	721,	721,	722,	721,	722,	722],
[722, 722,	722,	721,	722,	722,	722,	722,	722,	721,	722,	722,	721,	722,	722,	721,	721,	721,	722,	721,	721,	722,	722,	722,	721,	722,	722,	722,	722, 	722,	722,	722,	721,	722,	722],
[722, 722,	722,	721,	722,	722,	722,	722,	722,	721,	721,	722,	721,	722,	722,	721,	721,	721,	721,	721,	722,	722,	722,	722,	721,    722,	722,	722,	722,	722,	722,	722,	721,	722,	722],
[722, 721,	721,	721,	721,	721,	721,	721,	721,	722,	721,	722,	721,	721,	722,	721,	721,	722,	721,	722,	722,	722,	722,	722,	721,	722,	721,	721,	721,	721,	721,	722,	721,	722,	722],
[722, 722,	722,	722,	722,	722,	721,	722,	721,	721,	721,	722,	722,	721,	721,	722,	722,	722,	722,	722,	722,	722,	722,	722,	721,	721,	721,	722,	722,	722,	721,	721,	721,	722,	722],
[722, 722,	722,	722,	722,	722,	722,	722,	722,	722,	722,	722,	722,	722,	722,	722,	722,	722,	722,	722,	722,	722,	722,	722,	722,	722,	722,	722,	722,	722,	722,	722,	722,	722, 	722],
[722, 722,	722,	722,	722,	722,	722,	722,	722,	722,	722,	722,	722,	722,	722,	722,	722,	722,	722,	722,	722,	722,	722,	722,	722,	722,	722,	722,	722,	722,	722,	722,	722,	722,	722]

],
[
[0, 0,	0,	0,	0,	0,	0,	0,	0,	0,	0,	0,	0,	0,	0,	0,	0,	0,	0,	0,	0,	0,	0,	0,	0,	0,	0,	0,	0,	0,	0,	0,	0,	0,	0],	
[0, 0,	101,103,0,	1002,99,0,	0,	0,	0,	101,0,	0,	101,101,0,	0,	101,0,	0,	0,	0,	0,	0,	0,	102,0,	1001,0,	101,0,	0,	0,	0],
[0, 0,	0,	0,	0,	0,	0,	0,	0,	0,101,	0,	0,	0,	0,	0,	0,	0,	0,	0,	0,	0,	0,	0,	0,	101,0,	0,	0,	0,	0,	0,	0,	0,	0],
[0, 0,	0,	0,	0,	0,	0,	0,	0,	0,	0,	0,	0,	0,	0,	101,0,	0,	0,	0,	0,	0,	101,0,	0,	0,	0,	0,	0,	0,	0,	0,	101,0,	0],
[0, 0,	0,	0,	0,	0,	0,	0,	0,	0,	0,	0,	0,	0,	0,	0,	0,	101,0,	101,0,	0,	0,	303,0,	0,	0,	0,	0,	101,0,	0,	102,0,	0],
[0, 101,0,	0,	0,	0,101,	0,	0,	0,	0,	101,0,	0,	0,	0,	0,	0,	0,	0,	0,	0,	0,	103,0,	0,	0,	0,	0,	0,	0,	0,	0,	0,	0],
[0, 0,	0,101,	0,	0,	0,	0,	0,	0,	0,	101,0,	0,	0,	0,	0,	0,	0,	0,	0,	0,	303,0,	0,	102,0,	0,	0,	0,	0,	0,	0,	0,	0],
[0, 101,0,	0,	0,	0,	0,	0,	0,	0,	0,	0,	0,	0,	0,	0,	0,	101,0,	0,	0,	0,	101,0,	0,	0,	0,	0,	101,0,	0,	0,	101,0,	0],
[0, 0,	0,	0,	0,	0,	0,	0,	0,	0,	0,	0,	0,	0,	0,	0,	0,	0,	101,0,	0,	0,	0,	0,	0,	0,	0,	0,	0,	0,	0,	0,	0,	0,	0],
[0, 0,	0,	0,	0,	0,	0,	0,	0,	101,101,0,	0,	303,0,	103,101,0,	0,	0,	101,0,	0,	101,0,	0,	0,	0,	0,	0,	0,	0,	101,0,	0],
[0, 0,	0,	0,	0,	101,0,	0,	0,	0,	0,	0,	0,	0,	0,	0,	0,	0,	0,	0,	0,	0,	0,	0,	0,	101,0,	0,	0,	0,	0,	0,	0,	0,	0],
[0, 0,	0,	0,	0,	0,	0,	0,	0,	0,	0,	0,	0,	0,	101,	0,	0,	0,	0,	0,	0,	0,	0,	0,	0,	101,0,	0,	0,	0,	0,	0,	0,	0,	0],
[0, 0,	0,	0,	0,	101,0,	0,	0,	0,	101,	0,	0,	0,	0,	0,	0,	0,	0,	0,	101,0,	0,	0,	0,	0,	0,	0,	0,	0,	101,0,	101,0,	0],
[0, 0,	0,	0,	0,	0,	0,	0,	0,	0,	0,	0,	0,	0,	0,	0,	0,	0,	101,	0,	0,	0,	0,	0,	0,	0,	0,	101,	0,	101,	0,	0,	0,	0,	0],
[0, 0,	0,	0,	0,	0,	0,	0,	0,	0,	0,	0,	0,	0,	0,	0,	0,	0,	0,	0,	0,	0,	0,	0,	0,	0,	0,	0,	0,	0,	0,	0,	0,	0,	0],
[0, 0,	0,	0,	0,	0,	0,	0,	0,	0,	0,	0,	0,	0,	0,	0,	0,	0,	0,	0,	0,	101,0,	0,	0,	101,	0,	0,	0,	0,	101,0,	0,	0,	0],
[0, 0,	0,	101,0,	0,	0,	0,	0,	0,	0,	0,	103,504,0,	0,	0,	0,	101,0,	0,	101,0,	0,	0,	0,	0,	0,	0,	0,	0,	0,	0,	0,	0],
[0, 101,0,	0,	0,	0,	0,	0,	0,	0,	0,	101,103,0,	0,	0,	101,0,	0,	0,	0,	0,	0,	101,0,	0,	0,	101,0,	0,	0,	0,	0,	0,	0],
[0, 0,	0,	101,0,	0,	0,	0,	0,	1002,0,	103,101,0,	0,	0,	0,	0,	0,	101,	0,	0,	0,	0,	0,	0,	0,	0,	0,	0,	0,	0,	0,	0,	0],
[0, 101,0,	0,101,	0,	0,	0,	0,	0,	103,0,	0,	0,	0,	0,	0,	0,	0,	0,	102,0,	101,101,0,	101,0,	0,	0,	0,	0,	0,	0,	0,	0],
[0, 0,	0,	0,	0,	0,	0,	0,	0,	0,	0,	0,	0,	0,	0,	0,	0,	0,	0,	0,	0,	0,	0,	0,	0,	101,0,	0,	0,	0,	0,	0,	101,0,	0],
[0, 0,	0,	0,	0,	0,	0,	0,	0,	0,	0,	0,	0,	0,	0,	0,	0,	101,0,	0,	0,	0,	0,	0,	0,	0,	0,	0,	101,0,	0,	0,	101,0,	0],
[0, 0,	0,	0,	0,	0,	0,	0,	0,	0,	0,	0,	0,	0,	0,	0,	0,	0,	0,	0,	0,	0,	0,	0,	0,	0,	101,0,	0,	0,	0,	0,	0,	0,	0],
[0, 0,	101,0,	0,	0,	0,	0,	0,	0,	0,	0,	0,	0,	0,	0,	0,	0,	0,	0,	202,0,	0,	0,	0,	0,	0,	0,	0,	0,	0,	0,	0,	0,	0],
[0, 0,	0,	0,	0,	0,	0,	0,	0,	0,	0,	0,	0,	0,	0,	0,	0,	0,	0,	0,	0,	0,	0,	0,	0,	0,	0,	101,0,	0,	0,	0,	0,	0,	0],
[0, 0,	0,	101,0,	0,	0,	0,	0,	0,	0,	0,	0,	0,	0,	0,	0,	0,	0,	0,	0,	0,	0,	0,	0,	0,	0,	0,	0, 	0,	0,	0,	0,	0,	0],
[0, 0,	0,	0,	0,	0,	0,	0,	0,	0,	0,	0,	101,0,	0,	0,	301,0,	0,	0,	0,	0,	0,	0,	505,0,	0,	0,	0,	0,	0,	0,	0,	0,	0],
[0, 102,0,	101,0,	101,0,	0,	0,	0,	0,	0,	101,0,	0,	0,	1001,0,	0,	0,	0,	0,	0,	0,	0,	0,	0,	0,	0,	0,	0,	0,	0,	0,	0],
[0, 0,	0,	0,	0,	0,	28,	0,	0,	101,101,0,	0,	0,	101,0,	0,	0,	0,	0,	0,	0,	0,	0,	0,	0,	0,	0,	0,	0,	101,0,	101,0,	0],
[0, 0,	0,	0,	0,	0,	98,	0,	0,	0,	0,	0,	0,	0,	0,	0,	0,	0,	0,	0,	0,	0,	0,	0,	0,	0,	0,	0,	0,	0,	0,	0,	0,	0, 	0],
[0, 0,	0,	0,	0,	0,	0,	0,	0,	0,	0,	0,	0,	0,	0,	0,	0,	0,	0,	0,	0,	0,	0,	0,	0,	0,	0,	0,	0,	0,	0,	0,	0,	0,	0]
]
]
}
