{
"type":"map",
"cols": 31,
"rows": 36,
"totalLayers": 2,
"tSize": 64,
"playerLayer": 1,

"tiles":
[
[1,	1,	1,	1,	1,	1,	1,	1,	1,	1,	1,	1,	1,	1,	1,	1,	1,	1,	1,	1,	1,	1,	1,	1,	1,	1,	1,	1,	1,	1,	1,	1],
[1,	1,	1,	0,	1,	0,	0,	0,	1,	1,	1,	0,	0,	1,	0,	0,	0,	0,	0,	1,	0,	1,	0,	0,	0,	0,	1,	1,	1,	1,	1,	1],
[1,	1,	0,	1,	0,	0,	0,	0,	1,	0,	0,	0,	0,	0,	0,	1,	1,	0,	0,	0,	0,	1,	0,	0,	1,	0,	0,	0,	1,	1,	1,	1],
[1,	0,	0,	0,	1,	0,	1,	1,	0,	0,	0,	0,	0,	0,	1,	0,	1,	0,	1,	0,	0,	0,	0,	0,	1,	1,	1,	0,	1, 	1,	1,	1],
[1,	0,	1,	0,	1,	1,	1,	1,	1,	1,	1,	1,	1,	0,	1,	0,	1,	0,	1,	0,	1,	0,	1,	1,	1,	1,	0,	0,	0,	0,	1,	1],
[1,	0,	1,	0,	1,	1,	0,	0,	0,	0,	0,	0,	0,	0,	0,	0,	1,	1,	1,	0,	1,	0,	1,	1,	1,	1,	1,	0,	1,	0,	1,	1],
[1,	0,	0,	0,	0,	1,	0,	0,	1,	0,	0,	0,	1,	1,	1,	0,	1,	1,	1,	0,	1,	0,	1,	0,	1,	1,	1,	0,	1,	0,	1,	1],
[1,	0,	1,	1,	0,	1,	0,	1,	1,	0,	0,	0,	0,	0,	0,	0,	1,	1,	1,	0,	1,	0,	0,	0,	0,	1,	1,	1,	1,	0,	1,	1],
[1,	1,	1,	1,	0,	1,	0,	1,	1,	1,	0,	0,	0,	0,	1,	1,	1,	0,	0,	1,	1,	1,	1,	1,	1,	1,	0,	0,	0,	0,	1,	1],
[1,	1,	1,	1,	0,	0,	0,	1,	1,	0,	0,	1,	1,	0,	1,	0,	0,	1,	1,  1,  1,  1,  1,  1,	1,	1,	0,	0,	0,	1,	1,	1],
[1,	1,	1,	1,	0,	0,	1,	1,	1,	1,	1,	1,	1,	0,	0,	1,	1,	1,	0,	0,	0,	0,	1,	1,	1,	1,	0,	0,	0,	0,	1,	1],
[1,	1,	1,	1,	1,	1,	1,	0,	1,	0,	0,	1,	1,	1,	1,	1,	1,	1,	0,	0,	0,	0,	0,	1,	1,	1,	1,	1,	1,	0,	1,	1],
[1,	0,	0,	0,	0,	0,	0,	0,	0,	0,	0,	0,	0,	0,	0,	0,	0,	0,	0,	0,	0,	0,	0,	1,	1,	1,	1,	1,	0,	0,	1,	1],
[1,	0,	0,	0,	1,	1,	1,	1,	1,	1,	1,	0,	1,	0,	1,	1,	0,	1,	0,	1,	1,	1,	1,	1,	1,	1,	1,	0,	0,	1,	1,	1],
[1,	1,	1,	1,	1,	1,	1,	1,	1,	1,	1,	1,	1,	1,	1,	1,	1,	1,	0,	1,	1,	1,	0,	1,	1,	1,	1,	1,	0,	1,	1,	1],
[1,	1,	1,	0,	1,	1,	1,	1,	1,	1,	1,	1,	1,	1,	1,	1,	0,	0,	0,	1,	1,	0,	0,	1,	1,	1,	0,	1,	0,	0,	1,	1],
[1,	1,	1,	0,	0,	0,	1,	1,	1,	1,	1,	1,	0,	0,	0,	0,	0,	1,	0,	0,	1,	0,	1,	0,	0,	1,	0,	1,	1,	0,	1,	1],
[1,	0,	0,	0,	0,	0,	1,	1,	1,	1,	1,	0,	0,	1,	1,	0,	0,	1,	1,	0,	1,	0,	1,	0,	0,	1,	0,	1,	0,	0,	1,	1],
[1,	0,	0,	0,	0,	0,	0,	1,	1,	1,	0,	0,	0,	1,	1,	1,	1,	1,	1,	0,	0,	1,	1,	0,	0,	0,	0,	1,	0,	1,	1,	1],
[1,	0,	1,	0,	0,	0,	0,	1,	1,	1,	0,	1,	1,	1,	1,	1,	1,	1,	1,	1,	0,	1,	1,	1,	1,	1,	1,	1,	0,	0,	1,	1],
[1,	0,	1,	1,	1,	1,	1,	1,	0,	1,	0,	0,	0,	1,	1,	1,	1,	1,	1,	1,	0,	0,	1,	1,	1,	1,	1,	1,	0,	0,	1,	1],
[1,	0,	0,	0,	0,	1,	1,	0,	0,	1,	0,	1,	0,	1,	1,	0,	0,	0,	1,	1,	1,	0,	1,	1,	1,	1,	1,	1,	1,	0,	1,	1],
[1,	0,	0,	0,	0,	0,	0,	0,	0,	1,	0,	1,	1,	1,	1,	0,	1,  1,  1,  1,  1,  0,  0,	0,	1,	1,	1,	1,	0,	0,	1,	1],
[1,	1,	0,	0,	0,	0,	1,	0,	1,	1,	0,	0,	0,	0,	0,	0,	0,	1,	1,	1,	0,	0,	0,  0,	1,	1,	0,	0,	0,	0,	1,	1],
[1,	1,	1,	0,	1,	1,	1,	0,	1,	1,	1,	1,	0,	1,	0,	0,	0,	1,	1,	1,	0,	0,	0,	0,	0,	1,	0,	0,	1,	1,	1,	1],
[1,	0,	0,	1,	1,	1,	1,	1,	1,	1,	1,	1,	1,	1,	1,	0,	0,	0,	1,	1,	0,	1,	1,	1,	0,	1,	0,	0,	1,	1,	1,	1],
[1,	0,	0,	1,	0,	0,	1,	0,	1,	1,	1,	0,	1,	1,	1,	0,	0,	0,	1,	1,	0,	0,	0,	1,	0,	0,	1,	0,	0,	1,	1,	1],
[1,	0,	0,	0,	0,	1,	0,	0,	1,	1,	1,	0,	0,	1,	0,	0,	0,	1,	0,	1,	1,	0,	0,	0,	0,	1,	0,	0,	1,	1,	1,	1],
[1,	0,	0,	0,	0,	0,	0,	1,	1,	1,	1,	0,	0,	0,	0,	1,	1,	1,	1,	1,	1,	1,	1,	0,	1,	1,	0,	1,	1,	1,	1,	1],
[1,	1,	1,	1,	1,	0,	1,	1,	1,	1,	1,	1,	0,	0,	1,	1,	1,	1,	1,	1,	1,	1,	1,	1,	1,  1,	0,	0,	0,	1,	1,	1],
[1,	1,	1,	0,	0,	0,	1,	1,	1,	1,	1,	1,	0,	0,	1,	1,	1,	1,	1,	1,	1,	1,	1,	1,	1,	1,	1,	1,	0,	0,	1,	1],
[1,	1,	1,	0,	1,	1,	1,	1,	1,	1,	1,	1,	1,	1,	1,	1,	1,	1,	1,	1,	1,	1,	1,	1,	1,	1,	1,	1,	1,	0,	1,	1],
[1,	1,	1,	0,	0,	0,	1,	1,	1,	0,	0,	0,	0,	0,	0,	1,	1,	0,	0,	0,	0,	0,	1,	0,	1,	0,	0,	0,	0,	0,	1,	1],
[1,	1,	1,	1,	1,	0,	0,	0,	0,	0,	1,	0,	0,	1,	0,	0,	0,	0,	0,	1,	1,	0,	0,	0,	0,	0,	1,	0,	1,	1,	1,	1],
[1,	1,	1,	1,	1,	1,	1,	1,	1,	1,	1,	1,	1,	1,	1,	1,	1,	1,	1,	1,	1,	1,	1,	1,	1,	1,	1,	1,	1,	1,	1,	1],
[1,	1,	1,	1,	1,	1,	1,	1,	1,	1,	1,	1,	1,	1,	1,	1,	1,	1,	1,	1,	1,	1,	1,	1,	1,	1,	1,	1,	1,	1,	1,	1]
],

"layers":
[[
[722, 722,	722,	722,	722,	722,	722,	722,	722,	722,	722,	722,	722,	722,	722,	722,	722,	722,	722,	722,	722,	722,	722,	722,	722,	722,	722,	722,	722,	722,  722,	722],
[722, 722,	721,	721,	722,	721,	721,	721,	722,	722,	722,	721,	721,	722,	721,	721,	721,	721,	721,	722,	721,	722,	721,	721,	721,	721,	722,	722,	722,	722,	722,	722],
[722, 722,	721,	722,	721,	721,	721,	721,	721,	721,	721,	721,	721,	721,	721,	722,	722,	721,	721,	721,	721,	722,	721,	721,	722,	721,	721,	721,	722,	722,	722,	722],
[722, 721,	721,	721,	722,	721,	722,	722,	721,	721,	721,	721,	721,	721,	722,	721,	722,	721,	722,	721,	721,	721,	721,	721,	722,	722,	722,	721,	722, 	722,	722,	722],
[722, 721,	722,	721,	722,	722,	722,	722,	722,	722,	722,	722,	722,	721,	722,	721,	722,	721,	722,	721,	722,	721,	722,	722,	722,	722,	721,	721,	721,	721,	722,	722],
[722, 721,	722,	721,	722,	722,	721,	721,	721,	721,	721,	721,	721,	721,	721,	721,	722,	722,	722,	721,	722,	721,	722,	722,	722,	722,	722,	721,	722,	721,	722,	722],
[722, 721,	721,	721,	721,	722,	721,	721,	722,	721,	721,	721,	722,	722,	722,	721,	722,	722,	722,	721,	722,	721,	722,	721,	722,	722,	722,	721,	722,	721,	722,	722],
[722, 721,	722,	722,	721,	722,	721,	722,	722,	721,	721,	721,	721,	721,	721,	721,	722,	722,	722,	721,	722,	721,	721,	721,	721,	722,	722,	722,	722,	721,	722,	722],
[722, 722,	722,	722,	721,	722,	721,	722,	722,	722,	721,	721,	721,	721,	722,	722,	722,	721,	721,	722,	722,	722,	722,	722,	722,	722,	721,	721,	721,	721,	722,	722],
[722, 722,	722,	722,	721,	721,	721,	722,	722,	721,	721,	722,	722,	721,	722,	721,	721,	722,	722,  722,  722,  722,  722,  722,	722,	722,	721,	721,	721,	722,	722,	722],
[722, 722,	722,	722,	721,	721,	722,	722,	722,	722,	722,	722,	722,	721,	721,	722,	722,	722,	721,	721,	721,	721,	722,	722,	722,	722,	721,	721,	721,	721,	722,	722],
[722, 722,	722,	722,	722,	722,	722,	721,	722,	721,	721,	722,	722,	722,	721,	722,	722,	722,	721,	721,	721,	721,	721,	722,	722,	722,	722,	722,	722,	721,	722,	722],
[722, 721,	721,	721,	721,	721,	721,	721,	721,	721,	721,	721,	721,	721,	721,	721,	721,	721,	721,	721,	721,	721,	721,	722,	722,	722,	722,	722,	721,	721,	722,	722],
[722, 721,	721,	721,	722,	722,	722,	722,	722,	722,	722,	721,	722,	721,	722,	722,	721,	722,	721,	722,	722,	722,	722,	722,	722,	722,	722,	721,	721,	722,	722,	722],
[722, 722,	722,	721,	722,	722,	722,	722,	722,	722,	722,	722,	722,	722,	722,	722,	722,	722,	721,	722,	722,	722,	721,	722,	722,	722,	722,	722,	721,	722,	722,	722],
[722, 722,	722,	721,	722,	722,	722,	722,	722,	722,	722,	722,	722,	722,	722,	722,	721,	721,	721,	722,	722,	721,	721,	722,	722,	722,	721,	722,	721,	721,	722,	722],
[722, 722,	722,	721,	721,	721,	722,	722,	722,	722,	722,	722,	721,	721,	721,	721,	721,	722,	721,	721,	722,	721,	722,	721,	721,	722,	721,	722,	722,	721,	722,	722],
[722, 721,	721,	721,	721,	721,	722,	722,	722,	722,	722,	721,	721,	722,	722,	721,	721,	722,	722,	721,	722,	721,	722,	721,	721,	722,	721,	722,	721,	721,	722,	722],
[722, 721,	721,	721,	721,	721,	721,	722,	722,	722,	721,	721,	721,	722,	722,	722,	722,	722,	722,	721,	721,	722,	722,	721,	721,	721,	721,	722,	721,	722,	722,	722],
[722, 721,	722,	721,	721,	721,	721,	722,	722,	722,	721,	722,	722,	722,	722,	722,	722,	722,	722,	722,	721,	722,	722,	722,	722,	722,	722,	722,	721,	721,	722,	722],
[722, 721,	722,	722,	722,	722,	722,	722,	721,	722,	721,	721,	721,	722,	722,	722,	722,	722,	722,	722,	721,	721,	722,	722,	722,	722,	722,	722,	721,	721,	722,	722],
[722, 721,	721,	721,	721,	722,	722,	721,	721,	722,	721,	722,	721,	722,	722,	721,	721,	721,	722,	722,	722,	721,	722,	722,	722,	722,	722,	722,	722,	721,	722,	722],
[722, 721,	721,	721,	721,	721,	721,	721,	721,	722,	721,	722,	722,	722,	722,	721,	722,    722,    722,  722,  722,  721,  721,	721,	722,	722,	722,	722,	721,	721,	722,	722],
[722, 722,	721,	721,	721,	721,	722,	721,	722,	722,	721,	721,	721,	721,	721,	721,	721,	722,	722,	722,	721,	721,	721,  721,	722,	722,	721,	721,	721,	721,	722,	722],
[722, 722,	722,	721,	722,	722,	722,	721,	722,	722,	722,	722,	721,	722,	721,	721,	721,	722,	722,	722,	721,	721,	721,	721,	721,	722,	721,	721,	722,	722,	722,	722],
[722, 721,	721,	722,	722,	722,	722,	722,	722,	722,	722,	722,	722,	722,	722,	721,	721,	721,	722,	722,	721,	722,	722,	722,	721,	722,	721,	721,	722,	722,	722,	722],
[722, 721,	721,	722,	721,	721,	722,	721,	722,	722,	722,	721,	722,	722,	722,	721,	721,	721,	721,	722,	721,	721,	721,	722,	721,	721,	722,	721,	721,	722,	722,	722],
[722, 721,	721,	721,	721,	722,	721,	721,	722,	722,	722,	721,	721,	722,	721,	721,	721,	722,	721,	722,	722,	721,	721,	721,	721,	722,	721,	721,	722,	722,	722,	722],
[722, 721,	721,	721,	721,	721,	721,	722,	722,	722,	722,	721,	721,	721,	721,	722,	722,	722,	722,	722,	722,	722,	722,	721,	722,	722,	721,	722,	722,	722,	722,	722],
[722, 722,	722,	722,	722,	721,	722,	722,	722,	722,	722,	722,	721,	721,	722,	722,	722,	722,	722,	722,	722,	722,	722,	722,	722,   722,	721,	721,	721,	722,	722,	722],
[722, 722,	722,	721,	721,	721,	722,	722,	722,	722,	722,	722,	721,	721,	722,	722,	722,	722,	722,	722,	722,	722,	722,	722,	722,	722,	722,	722,	721,	721,	722,	722],
[722, 722,	722,	721,	722,	722,	722,	722,	722,	722,	722,	722,	722,	722,	722,	722,	722,	722,	722,	722,	722,	722,	722,	722,	722,	722,	722,	722,	722,	721,	722,	722],
[722, 722,	722,	721,	721,	721,	722,	722,	722,	721,	721,	721,	721,	721,	721,	722,	722,	721,	721,	721,	721,	721,	722,	721,	722,	721,	721,	721,	721,	721,	722,	722],
[722, 722,	722,	722,	722,	721,	721,	721,	721,	721,	722,	721,	721,	722,	721,	721,	721,	721,	721,	722,	722,	721,	721,	721,	721,	721,	722,	721,	722,	722,	722,	722],
[722, 722,	722,	722,	722,	722,	722,	722,	722,	722,	722,	722,	722,	722,	722,	722,	722,	722,	722,	722,	722,	722,	722,	722,	722,	722,	722,	722,	722,	722,  722,	722],
[722,	722,	722,	722,	722,	722,	722,	722,	722,	722,	722,	722,	722,	722,	722,	722,	722,	722,	722,	722,	722,	722,	722,	722,	722,	722,	722,	722,	722,	722,  722,	722]


],
[
[0, 0,	0,	0,	0,	0,	0,	0,	0,	0,	0,	0,	0,	0,	0,	0,	0,	0,	0,	0,	0,	0,	0,	0,	0,	0,	0,	0,	0,	0,  0,	0],
[0, 0,	1002,99,0,	103,103,101,0,	0,	0,	0,	101,	0,	0,	0,	0,	0,	101,	0,	0,	0,	101,	0,	0,	0,	0,	0,	0,	0,	0,	0],
[0, 0,	0,	0,	103,103,103,101,1002,102,	0,	0,	0,	0,	0,	0,	0,	0,	0,	0,	0,	0,	0,	0,	0,	0,	0,	0,	0,	0,	0,	0],
[0, 0,	0,	0,	0,	103,0,	0,	101,	0,	0,	0,	0,	0,	0,	0,	0,	0,	0,	0,	0,	0,	0,	0,	0,	0,	0,	0,	0, 	0,	0,	0],
[0, 0,	0,	0,	0,	0,	0,	0,	0,	0,	0,	0,	0,	0,	0,	0,	0,	101,	0,	0,	0,	0,	0,	0,	0,	0,	0,	0,	0,	0,	0,	0],
[0, 0,	0,	0,	0,	0,	0,	0,	0,	0,	0,	0,	0,	0,	0,	0,	0,	0,	0,	0,	0,	0,	0,	0,	0,	0,	0,	0,	0,	0,	0,	0],
[0, 0,	0,	0,	0,	0,	0,	101,	0,	0,	0,	0,	0,	0,	0,	0,	0,	0,	0,	0,	0,	0,	0,	0,	0,	0,	0,	102,	0,	0,	0,	0],
[0, 101,	0,	0,	0,	0,	0,	0,	0,	0,	0,	0,	0,	0,	0,	0,	0,	0,	0,	101,	0,	0,	0,	0,	1001,0,	0,	0,	0,	0,	0,	0],
[0, 0,	0,	0,	0,	0,	0,	0,	0,	0,	0,	0,	0,	0,	0,	0,	0,	0,	0,	0,	0,	0,	0,	0,	0,	0,	101,	0,	0,	0,	0,	0],
[0, 0,	0,	0,	0,	0,	0,	0,	0,	0,	0,	0,	0,	0,	0,	101,	0,	0,	0,  0,  0,  0,  0,  0,	0,	0,	0,	0,	0,	0,	0,	0],
[0, 0,	0,	0,	0,	0,	0,	0,	0,	0,	0,	0,	0,	0,	101,	0,	0,	0,	101,	0,	0,	101,	0,	0,	0,	0,	101,	0,	0,	0,	0,	0],
[0, 0,	0,	0,	0,	0,	0,	0,	0,	0,	0,	0,	0,	0,	507,	0,	0,	0,	0,	0,	0,	0,	0,	0,	0,	0,	0,	0,	0,	0,	0,	0],
[0, 0,	0,	0,	0,	0,	0,	0,	0,	0,	0,	0,	0,	0,	0,	0,	0,	0,	0,	0,	101,	0,	101,	0,	0,	0,	0,	0,	0,	0,	0,	0],
[0, 0,	0,	0,	0,	0,	0,	0,	0,	0,	0,	101,	0,	101,	0,	0,	0,	0,	0,	0,	0,	0,	0,	0,	0,	0,	0,	0,	0,	0,	0,	0],
[0, 0,	0,	506,	0,	0,	0,	0,	0,	0,	0,	0,	0,	0,	0,	0,	0,	0,	0,	0,	0,	0,	101,	0,	0,	0,	0,	0,	0,	0,	0,	0],
[0, 0,	0,	0,	0,	0,	0,	0,	0,	0,	0,	0,	0,	0,	0,	0,	0,	0,	0,	0,	0,	0,	0,	0,	0,	0,	101,	0,	0,	0,	0,	0],
[0, 0,	0,	0,	0,	101,	0,	0,	0,	0,	0,	0,	0,	0,	0,	0,	0,	0,	0,	0,	0,	0,	0,	101,	101,	0,	0,	0,	0,	0,	0,	0],
[0, 102,	0,	0,	0,	0,	0,	0,	0,	0,	0,	0,	0,	0,	0,	0,	0,	0,	0,	0,	0,	0,	0,	0,	0,	0,	0,	0,	101,	0,	0,	0],
[0, 0,	101,301,0,	0,	0,	0,	0,	0,	0,	0,	101,	0,	0,	0,	0,	0,	0,	0,	0,	0,	0,	101,	0,	0,	101,	0,	0,	0,	0,	0],
[0, 101,	0,	0,	101,	0,	101,	0,	0,	0,	0,	0,	0,	0,	0,	0,	0,	0,	0,	0,	0,	0,	0,	0,	0,	0,	0,	0,	0,	101,	0,	0],
[0, 0,	0,	0,	0,	0,	0,	0,	101,	0,	0,	0,	0,	0,	0,	0,	0,	0,	0,	0,	0,	0,	0,	0,	0,	0,	0,	0,	0,	0,	0,	0],
[0, 0,	303,0,	101,	0,	0,	0,	0,	0,	0,	0,	0,	0,	0,	0,	0,	102,	0,	0,	0,	0,	0,	0,	0,	0,	0,	0,	0,	0,	0,	0],
[0, 0,	0,	0,	0,	0,	0,	0,	101,	0,	0,	0,	0,	0,	0,	0,	0,  0,  0,  0,  0,  0,  0,	101,	0,	0,	0,	0,	0,	0,	0,	0],
[0, 0,	101,	0,	0,	0,	0,	0,	0,	0,	0,	0,	0,	0,	0,	0,	0,	0,	0,	0,	101,	0,	0,  0,	0,	0,	101,	0,	0,	101,	0,	0],
[0, 0,	0,	101,	0,	0,	0,	101,	0,	0,	0,	0,	101,	0,	0,	0,	0,	0,	0,	0,	0,	0,	0,	0,	0,	0,	0,	0,	0,	0,	0,	0],
[0, 101,	101,	0,	0,	0,	0,	0,	0,	0,	0,	0,	0,	0,	0,	0,	0,	0,	0,	0,	0,	0,	0,	0,	0,	0,	0,	0,	0,	0,	0,	0],
[0, 0,	0,	0,	0,	0,	0,	0,	0,	0,	0,	101,	0,	0,	0,	0,	0,	0,	508,	0,	0,	0,	0,	0,	0,	102,	0,	0,	0,	0,	0,	0],
[0, 0,	0,	0,	0,	0,	0,	0,	0,	0,	0,	0,	101,	0,	0,	101,	0,	0,	1001,	0,	0,	101,	0,	0,	101,	0,	0,	0,	0,	0,	0,	0],
[0, 101,	0,	0,	0,	0,	0,	0,	0,	0,	0,	0,	0,	0,	0,	0,	0,	0,	0,	0,	0,	0,	0,	0,	0,	0,	0,	0,	0,	0,	0,	0],
[0, 0,	0,	0,	0,	0,	0,	0,	0,	0,	0,	0,	0,	0,	0,	0,	0,	0,	0,	0,	0,	0,	0,	0,	0,  0,	0,	0,	0,	0,	0,	0],
[0, 0,	0,	0,	0,	0,	0,	0,	0,	0,	0,	0,	101,	0,	0,	0,	0,	0,	0,	0,	0,	0,	0,	0,	0,	0,	0,	0,	0,	0,	0,	0],
[0, 0,	0,	0,	0,	0,	0,	0,	0,	0,	0,	0,	0,	0,	0,	0,	0,	0,	0,	0,	0,	0,	0,	0,	0,	0,	0,	0,	0,	0,	0,	0],
[0, 0,	0,	101,	0,	0,	0,	0,	0,	0,	0,	0,	0,	0,	0,	0,	0,	0,	0,	0,	0,	0,	0,	101,0,	0,	0,	0,	0,	0,	0,	0],
[0, 0,	0,	0,	0,	0,	0,	0,	101,	0,	0,	101,	101,	0,	0,	0,	0,	101,301,0,	0,	103,0,	0,	0,	0,	0,	101,	0,	0,	0,	0],
[0, 0,	0,	0,	0,	0,	0,	0,	0,	0,	0,	0,	0,	0,	0,	0,	0,	0,	0,	0,	0,	0,	0,	0,	0,	0,	0,	0,	0,	0,  0,	0],
[0,	0,	0,	0,	0,	0,	0,	0,	0,	0,	0,	0,	0,	0,	0,	0,	0,	0,	0,	0,	0,	0,	0,	0,	0,	0,	0,	0,	0,	0,  0,	0]
]
]

}