{
"type":"map",
"cols": 36,
"rows": 41,
"totalLayers": 2,
"tSize": 64,
"playerLayer": 1,

"tiles":

[
[1,	1,	1,	1,	1,	1,	1,	1,	1,	1,	1,	1,	1,	1,	1,	1,	1,	1,	1,	1,	1,	1,	1,	1,	1,	1,	1,	1,	1,	1,	1,	1,	1,	1,	1,	1,	1],
[1,	0,	0,	0,	0,	0,	0,	0,	0,	0,	0,	1,	0,	0,	1,	1,	1,	1,	1,	1,	1,	1,	1,	0,	0,	0,	0,	0,	1,	1,	1,	1,	1,	1,	1,	1,	1],
[1,	0,	0,	0,	0,	1,	1,	1,	1,	1,	0,	0,	0,	1,	0,	0,	1,	1,	1,	1,	1,	1,	0,	0,	1,	1,	1,	0,	0,	0,	0,	1,	1,	1,	1,	1,	1],
[1,	0,	1,	1,	1,	1,	1,	1,	1,	1,	1,	1,	0,	1,	0,	0,	0,	0,	1,	1,	1,	1,	0,	1,	1,	1,	1,	1,	1, 	0,	0,	1,	1,	1,	1,	1,	1],
[1,	0,	0,	0,	0,	0,	0,	0,	0,	0,	0,	1,	0,	1,	1,	1,	1,	0,	1,	1,	1,	1,	0,	1,	0,	0,	0,	0,	0,	0,	0,	1,	1,	1,	1,	1,	1],
[1,	0,	1,	1,	1,	1,	1,	1,	1,	1,	0,	1,	0,	1,	1,	0,	0,	0,	1,	1,	1,	1,	0,	1,	0,	1,	1,	1,	1,	1,	1,	0,	0,	0,	0,	1,	1],
[1,	0,	0,	0,	0,	1,	1,	1,	1,	1,	0,	1,	0,	0,	0,	0,	1,	1,	1,	1,	1,	0,	0,	1,	0,	0,	0,	0,	0,	1,	1,	0,	1,	1,	1,	1,	1],	
[1,	1,	0,	1,	0,	0,	0,	0,	1,	1,	0,	1,	0,	1,	1,	0,	0,	1,	1,	1,	1,	0,	1,	0,	1,	1,	1,	1,	0,	1,	1,	0,	1,	0,	1,	1,	1],
[1,	0,	0,	1,	1,	1,	1,	0,	1,	1,	0,	1,	0,	1,	1,	1,	0,	1,	1,	1,	1,	0,	0,	0,	1,	1,	1,	0,	0,	1,	1,	0,	0,	0,	0,	1,	1],	
[1,	0,	1,	1,	0,	1,	0,	0,	1,	1,	0,	1,	0,	0,	1,	1,	0,	1,	1,  1,  1,  1,  1,  0,	1,	1,	1,	0,	1,	1,	1,	0,	0,	0,	1,	1,	1],
[1,	0,	1,	0,	0,	1,	0,	1,	1,	0,	0,	1,	0,	0,	0,	0,	0,	1,	1,	0,	0,	0,	0,	0,	1,	1,	1,	0,	0,	1,	0,	0,	0,	0,	1,	1,	1],
[1,	0,	1,	0,	1,	0,	0,	1,	1,	0,	0,	1,	0,	0,	1,	1,	1,	1,	1,	0,	1,	0,	0,	1,	1,	1,	1,	1,	1,	1,	1,	1,	1,	0,	1,	1,	1],
[1,	0,	1,	0,	0,	0,	1,	1,	1,	0,	0,	1,	0,	0,	1,	0,	0,	0,	0,	0,	1,	1,	1,	1,	1,	1,	1,	1,	1,	1,	1,	1,	1,	0,	0,	1,	1],	
[1,	0,	1,	0,	1,	0,	0,	0,	0,	0,	1,	1,	0,	0,	1,	0,	1,	1,	1,	1,	1,	1,	1,	0,	0,	0,	0,	1,	1,	1,	1,	0,	1,	1,	0,	1,	1],
[1,	0,	1,	0,	0,	0,	0,	0,	1,	1,	1,	1,	1,	1,	1,	0,	0,	0,	0,	1,	1,	1,	1,	0,	0,	0,	0,	1,	1,	1,	1,	0,	1,	0,	0,	1,	1],
[1,	0,	0,	1,	1,	0,	0,	0,	0,	0,	0,	0,	0,	1,	0,	0,	1,	0,	0,	1,	1,	1,	1,	1,	0,	1,	1,	1,	1,	1,	1,	0,	0,	0,	1,	1,	1],
[1,	1,	0,	1,	1,	0,	0,	0,	1,	1,	1,	1,	1,	1,	1,	1,	1,	1,	1,	1,	1,	1,	1,	1,	1,	1,	1,	1,	1,	1,	1,	1,	1,	1,	1,	1,	1],
[1,	1,	0,	1,	1,	1,	0,	1,	1,	1,	1,	1,	1,	1,	1,	1,	1,	1,	0,	0,	0,	0,	0,	0,	0,	0,	1,	1,	0,	0,	1,	1,	1,	1,	1,	1,	1],
[1,	0,	0,	1,	1,	1,	0,	0,	0,	0,	1,	1,	1,	1,	0,	0,	1,	0,	0,	0,	0,	1,	0,	0,	1,	0,	0,	0,	0,	0,	0,	0,	1,	0,	0,	1,	1],
[1,	0,	0,	1,	1,	0,	0,	1,	0,	1,	1,	1,	0,	1,	0,	0,	1,	1,	1,	1,	1,	1,	1,	1,	1,	1,	0,	0,	0,	1,	1,	1,	1,	0,	0,	1,	1],
[1,	0,	0,	0,	0,	0,	0,	1,	0,	0,	1,	1,	0,	0,	0,	1,	0,	0,	1,	1,	0,	1,	1,	0,	1,	1,	1,	1,	1,	1,	1,	1,	1,	0,	1,	1,	1],	
[1,	1,	1,	1,	1,	0,	1,	1,	1,	0,	1,	0,	1,	0,	1,	1,	0,	1,	0,	0,	0,	0,	0,	0,	1,	1,	0,	0,	1,	1,	1,	1,	1,	0,	0,	1,	1],
[1,	1,	1,	1,	1,	0,	1,	0,	0,	0,	1,	0,	0,	1,	0,	0,	0,  1,  0,  0,  0,  1,  1,	0,	0,	0,	1,	0,	0,	1,	1,	0,	0,	0,	1,	1,	1],
[1,	1,	1,	1,	1,	0,	0,	1,	1,	1,	1,	0,	0,	0,	0,	0,	1,	1,	0,	1,	0,	1,	1,  0,	1,	0,	1,	0,	0,	1,	0,	0,	0,	1,	1,	1,	1],
[1,	1,	1,	1,	1,	0,	0,	1,	1,	1,	1,	1,	0,	0,	1,	1,	1,	1,	0,	1,	0,	0,	1,	1,	1,	0,	0,	0,	1,	0,	0,	0,	0,	1,	1,	1,	1],
[1,	1,	1,	1,	1,	0,	0,	1,	1,	1,	0,	0,	0,	1,	1,	1,	0,	0,	1,	1,	1,	0,	0,	1,	1,	0,	1,	0,	1,	0,	0,	1,	1,	1,	0,	1,	1],
[1,	1,	1,	1,	1,	1,	0,	1,	1,	0,	0,	0,	1,	0,	1,	0,	0,	0,	0,	0,	1,	0,	0,	0,	0,	0,	1,	0,	1,	0,	0,	0,	1,	0,	0,	1,	1],
[1,	1,	1,	1,	1,	0,	0,	0,	0,	0,	0,	1,	0,	0,	0,	0,	1,	1,	0,	0,	1,	1,	1,	0,	0,	1,	1,	0,	1,	1,	0,	1,	1,	0,	1,	1,	1],
[0,	0,	0,	0,	1,	0,	0,	0,	0,	0,	1,	1,	0,	0,	0,	1,	1,	1,	0,	1,	1,	0,	0,	0,	1,	1,	0,	0,	1,	0,	0,	0,	0,	0,	0,	1,	1],
[1,	1,	1,	0,	1,	0,	0,	0,	1,	1,	0,	0,	0,	1,	1,	1,	0,	0,	1,	1,	1,	0,	0,	1,	1,  1,	0,	1,	1,	0,	1,	0,	0,	0,	1,	1,	1],
[1,	1,	0,	1,	1,	0,	0,	0,	1,	1,	1,	0,	1,	1,	0,	0,	0,	1,	0,	1,	1,	0,	1,	1,	1,	0,	0,	1,	1,	0,	1,	0,	0,	0,	0,	1,	1],
[1,	1,	0,	1,	1,	1,	1,	0,	1,	1,	1,	0,	1,	0,	0,	1,	0,	0,	0,	1,	0,	0,	1,	1,	1,	0,	1,	0,	1,	0,	1,	0,	0,	0,	1,	1,	1],
[1,	0,	0,	1,	1,	0,	1,	0,	1,	1,	1,	0,	0,	0,	0,	0,	1,	0,	1,	1,	0,	1,	1,	1,	1,	0,	0,	0,	1,	0,	1,	0,	1,	0,	0,	1,	1],	
[1,	0,	1,	0,	0,	0,	1,	1,	0,	0,	0,	0,	1,	1,	1,	0,	0,	1,	1,	0,	0,	1,	1,	1,	1,	1,	1,	1,	1,	0,	1,	0,	1,	0,	1,	1,	1],
[1,	0,	1,	0,	1,	1,	1,	1,	0,	1,	0,	1,	1,	0,	1,	1,	0,	1,	1,	1,	1,	1,	1,	1,	1,	1,	1,	1,	1,	0,	1,	0,	1,	0,	0,	1,	1],
[1,	0,	1,	0,	0,	0,	0,	0,	0,	0,	1,	1,	0,	1,	1,	0,	0,	0,	0,	1,	1,	1,	1,	1,	1,	1,	1,	0,	1,	0,	0,	0,	1,	0,	1,	1,	1],
[1,	0,	0,	1,	0,	0,	1,	0,	1,	0,	0,	0,	0,	1,	0,	0,	1,	0,	0,	0,	1,	0,	1,	0,	0,	0,	0,	1,	0,	1,	0,	0,	1,	0,	0,	1,	1],
[1,	1,	0,	1,	1,	0,	0,	1,	0,	0,	0,	1,	0,	0,	0,	1,	1,	0,	0,	0,	0,	0,	1,	0,	0,	1,	0,	0,	1,	0,	0,	0,	0,	0,	1,	1,	1],
[1,	0,	0,	0,	0,	0,	0,	0,	0,	1,	0,	1,	1,	1,	0,	0,	1,	0,	1,	1,	1,	1,	1,	1,	1,	0,	0,	0,	1,	0,	0,	1,	1,	0,	0,	1,	1],
[1,	1,	1,	1,	1,	1,	1,	1,	1,	1,	1,	1,	1,	1,	1,	1,	0,	1,	1,	1,	1,	1,	1,	1,	1,	1,	1,	1,	1,	1,	1,	1,	1,	1,	1,	1,	1],
[1,	1,	1,	1,	1,	1,	1,	1,	1,	1,	1,	1,	1,	1,	1,	1,	1,	1,	1,	1,	1,	1,	1,	1,	1,	1,	1,	1,	1,	1,	1,	1,	1,	1,	1,	1,	1]
],
"layers":
[[
[761,   761,	761,	761,	761,	761,	761,	761,	761,	761,	761,	761,	761,	761,	761,	761,	761,	761,	761,	761,	761,	761,	761,	761,	761,	761,	761,	761,	761,	761,	761,	761,	761,	761,	761,  761,  761],
[761,	724,	724,	724,	724,	724,	724,	724,	724,	724,	724,	761,	724,	724,  761,	761,	761,	761,	761,	761,	761,	761,	761,	724,	724,	724,	724,	724,	761,	761,	761,	761,	761,	761,	761,	761,	761],
[761,	724,	724,	724,	724,	761,	761,	761,	761,	761,	724,	724,	724,	761,	724,	724,	761,	761,	761,	761,	761,	761,	724,	724,	761,	761,	761,	724,	724,	724,	724,	761,	761,	761,	761,	761,	761],
[761,	724,	761,	761,	761,	761,	761,	761,	761,	761,	761,	761,	724,	761,	724,	724,	724,	724,	761,	761,	761,	761,	724,	761,	761,	761,	761,	761,	761, 	724,	724,	761,	761,	761,	761,	761,	761],
[761,	724,	724,	724,	724,	724,	724,	724,	724,	724,	724,	761,	724,	761,	761,	761,	761,	724,	761,	761,	761,	761,	724,	761,	724,	724,	724,	724,	724,	724,	724,	761,	761,	761,	761,	761,	761],
[761,	724,	761,	761,	761,	761,	761,	761,	761,	761,	724,	761,	724,	761,	761,	724,	724,	724,	761,	761,	761,	761,	724,	761,	724,	761,	761,	761,	761,	761,	761,	724,	724,	724,	724,	761,	761],
[761,	724,	724,	724,	724,	761,	761,	761,	761,	761,	724,	761,	724,	724,	724,	724,	761,	761,	761,	761,	761,	724,	724,	761,	724,	724,	724,	724,	724,	761,	761,	724,	761,	761,	761,	761,	761],	
[761,	761,	724,	761,	724,	724,	724,	724,	761,	761,	724,	761,	724,	761,	761,	724,	724,	761,	761,	761,	761,	724,	761,	724,	761,	761,	761,	761,	724,	761,	761,	724,	761,	724,	761,	761,	761],
[761,	724,	724,	761,	761,	761,	761,	724,	761,	761,	724,	761,	724,	761,	761,	761,	724,	761,	761,	761,	761,	724,	724,	724,	761,	761,	761,	724,	724,	761,	761,	724,	724,	724,	724,	761,	761],	
[761,	724,	761,	761,	724,	761,	724,	724,	761,	761,	724,	761,	724,	724,	761,	761,	724,	761,	761,  761,  761,  761,  761,  724,	761,	761,	761,	724,	761,	761,	761,	724,	724,	724,	761,	761,	761],
[761,	724,	761,	724,	724,	761,	724,	761,	761,	724,	724,	761,	724,	724,	724,	724,	724,	761,	761,	724,	724,	724,	724,	724,	761,	761,	761,	724,	724,	724,	724,	724,	724,	724,	761,	761,	761],
[761,	724,	761,	724,	761,	724,	724,	761,	761,	724,	724,	761,	724,	724,	761,	761,	761,	761,	761,	724,	761,	724,	724,	761,	761,	761,	761,	761,	761,	761,	761,	761,	761,	724,	761,	761,	761],
[761,	724,    761,	724,	724,	724,	761,	761,	761,	724,	724,	761,	724,	724,	761,	724,	724,	724,	724,	724,	761,	761,	761,	761,	761,	761,	761,	761,	761,	761,	761,	761,	761,	724,	724,	761,	761],	
[761,	724,	761,	724,	761,	724,	724,	724,	724,	724,	761,	761,	724,	724,	761,	724,	761,	761,	761,	761,	761,	761,	761,	724,  724,	724,	724,	761,	761,	761,	761,	724,  761,	761,	724,	761,	761],
[761,	724,	761,	724,	724,	724,	724,	724,	761,	761,	761,	761,	724,	761,	761,	724,	724,	724,	724,	761,	761,	761,	761,	724,	724,	724,	724,	761,	761,	761,	761,	724,	761,	724,	724,	761,	761],
[761,	724,	724,	761,	761,	724,	724,	724,	724,	724,	724,	724,	724,	724,	724,	724,	761,	724,	724,	761,	761,	761,	761,	761,	724,	761,	761,	761,	761,	761,	761,	724,	724,	724,	761,	761,	761],
[761,	761,	724,	761,	761,	724,	724,	724,	761,	761,	761,	761,	761,	761,	761,	761,	761,	761,	761,	761,	761,	761,	761,	761,	724,	761,	761,	761,	761,	761,	761,	761,	761,	761,	761,	761,	761],
[761,	761,	724,	761,	761,	761,	724,	761,	761,	761,	761,	761,	761,	761,	761,	761,	761,	761,	724,	724,	724,	724,  724,	724,	724,	724,	761,	761,	724,	724,	761,	761,	761,	761,	761,	761,	761],
[761,	724,	724,	761,	761,	761,	724,	724,	724,	724,	761,	761,	761,	761,	724,	724,	761,	724,	724,	724,	724,	761,	724,	724,	761,	724,	724,	724,	724,	724,	724,	724,	724,	724,	724,	761,	761],
[761,	724,	724,	761,	761,	724,	724,	761,	724,	761,	761,	761,	724,	761,	724,	724,	761,	724,	761,	761,	761,	761,	761,	761,	761,	761,	724,	724,	724,	761,	761,	761,	761,	724,	724,	761,	761],
[761,	724,	724,	724,	724,	724,	724,	761,	724,	724,	761,	761,	724,	724,	724,	761,	724,	724,	761,	761,	724,	761,	761,	724,	761,	761,	761,	761,	761,	761,	761,	761,	761,	724,	761,	761,	761],	
[761,	761,	761,	761,	761,	724,	761,	761,	761,	724,	761,	724,	761,	724,	761,	761,	724,	761,	724,	724,	724,	724,	724,	724,	761,	761,	724,	724,	761,	761,	761,	761,	761,	724,	724,	761,	761],
[761,	761,	761,	761,	761,	724,	761,	724,	724,	724,	761,	724,	724,	761,	724,	724,	724,  761,  724,  724,  724,  761,  761,	724,	724,	724,	761,	724,	724,	761,	761,	724,	724,	724,	761,	761,	761],
[761,	761,	761,	761,	761,	724,	724,	761,	761,	761,	761,	724,	724,	724,	724,	724,	761,	761,	724,	761,	724,	761,	761,  724,	761,	724,	761,	724,	724,	761,	724,	724,	724,	761,	761,	761,	761],
[761,	761,	761,	761,	761,	724,	724,	761,	761,	761,	761,	761,	724,	724,	761,	761,	761,	761,	724,	761,	724,	724,	761,	761,	761,	724,	724,	724,	761,	724,	724,	724,	724,	761,	761,	761,	761],
[761,	761,	761,	761,	761,	724,	724,	761,	761,	761,	724,	724,	724,	761,	761,	761,	724,	724,	761,	761,	761,	724,	724,	761,	761,	724,	761,	724,	761,	724,	724,	761,	761,	761,	724,	761,	761],
[761,	761,	761,	761,	761,	761,	724,	761,	761,	724,	724,	724,	761,	724,	761,	724,	724,	724,	724,	724,  761,	724,	724,	724,	724,	724,	761,	724,	761,	724,	724,	724,	761,	724,	724,	761,	761],
[761,	761,	761,	761,	761,	724,	724,	724,	724,	724,	724,	761,	724,	724,	724,	724,	761,	761,	724,	724,	761,	761,	761,	724,	724,	761,	761,	724,	761,	761,	724,	761,	761,	724,	761,	761,	761],
[761,	724,  724,	724,	761,	724,	724,	724,	724,	724,	761,	761,	724,	724,	724,	761,	761,	761,	724,	761,	761,	724,	724,	724,	761,	761,	724,	724,	761,	724,	724,	724,	724,	724,	724,	761,	761],
[761,	761,	761,	724,	724,	724,	724,	724,	761,	761,	724,	724,	724,	761,	761,	761,	724,	724,	761,	761,	761,	724,	724,	761,	761,  761,	724,	761,	761,	724,	761,	724,	724,	724,	761,	761,	761],
[761,	761,	724,	761,	761,	724,	724,	724,	761,	761,	761,	724,	761,	761,	724,	724,	724,	761,	724,	761,	761,	724,	761,	761,	761,	724,	724,	761,	761,	724,	761,	724,	724,	724,	724,	761,	761],
[761,	761,	724,	761,	761,	761,	761,	724,	761,	761,	761,	724,	761,	724,	724,	761,	724,	724,	724,	761,	724,	724,	761,	761,	761,	724,	761,	724,	761,	724,	761,	724,	724,	724,	761,	761,	761],
[761,	724,	724,	761,	761,	724,	724,	724,	761,	761,	761,	724,	724,	724,	724,	724,	761,	724,	761,	761,	724,	761,	761,	761,	761,	724,	724,	724,	761,	724,	761,	724,	761,	724,	724,	761,	761],	
[761,	724,	761,	724,	724,	724,	761,	761,	724,	724,	724,	724,	761,	761,	761,	724,	724,	761,	761,	724,	724,	761,	761,	761,	761,	761,	761,	761,	761,	724,	761,	724,	761,	724,	761,	761,	761],
[761,	724,	761,	724,	761,	761,	761,	761,	724,	761,	724,	761,	761,	724,	761,	761,	724,	761,	761,	761,	761,	761,	761,	761,	761,	761,	761,	761,	761,	724,	761,	724,	761,	724,	724,	761,	761],
[761,	724,	761,	724,	724,	724,	724,	724,	724,	724,	761,	761,	724,	761,	761,	724,	724,	724,	724,	761,	761,	761,	761,	761,	761,	761,	761,	724,  761,	724,	724,	724,	761,	724,	761,	761,	761],
[761,	724,	724,	761,	724,	724,	761,	724,	761,	724,	724,	724,	724,	761,	724,	724,	761,	724,	724,	724,	761,	724,	724,	724,	724,	724,	724,	761,	724,	761,	724,	724,	761,	724,	724,	761,	761],
[761,	761,	724,	761,	761,	724,	724,	761,	724,	724,	724,	761,	724,	724,	724,	761,	761,	724,	724,	724,	724,	724,	761,	724,	724,	761,	724,	724,  761,	724,	724,	724,	724,	724,	761,	761,	761],
[761,	724,	724,	724,	724,	724,	724,	724,	724,  761,	724,	761,	761,	761,	724,	724,	724,	724,	761,	761,	761,	761,	761,	761,	761,	724,	724,	724,	761,	724,	724,	761,	761,	724,	724,	761,	761],
[761, 761,	761,	761,	761,	761,	761,	761,	761,	761,	761,	761,	761,	761,	761,	761,	724,	761,	761,	761,	761,	761,	761,	761,	761,	761,	761,	761,	761,	761,	761,	761,	761,	761,	761,  761,	761],
[761, 761,	761,	761,	761,	761,	761,	761,	761,	761,	761,	761,	761,	761,	761,	761,	761,	761,	761,	761,	761,	761,	761,	761,	761,	761,	761,	761,	761,	761,	761,	761,	761,	761,	761,	761,	761]




],

[
[0, 0,	0,	0,	0,	0,	0,	0,	0,	0,	0,	0,	0,	0,	0,	0,	0,	0,	0,	0,	0,	0,	0,	0,	0,	0,	0,	0,	0,	0,	0,	0,	0,	0,	0,  0,  0],
[0,	101,0,	0,	0,	0,	0,	0,	0,	0,	0,	0,	101,103,  0,	0,	0,	0,	0,	0,	0,	0,	0,	0,	0,	0,	0,	0,	0,	0,	0,	0,	0,	0,	0,	0,	0],
[0,	0,	0,	0,	0,	0,	0,	0,	0,	0,	0,	0,	0,	0,	0,	0,	0,	0,	0,	0,	0,	0,	0,	0,	0,	0,	0,	0,	0,	101,103,	0,	0,	0,	0,	0,	0],
[0,	0,	0,	0,	0,	0,	0,	0,	0,	0,	0,	0,	0,	0,	0,	0,	0,	101,0,	0,	0,	0,	0,	0,	0,	0,	0,	0,	0, 	0,	0,	0,	0,	0,	0,	0,	0],
[0,	0,	0,	0,	0,	0,	0,	0,	0,	0,	0,	0,	0,	0,	0,	0,	0,	0,	0,	0,	0,	0,	0,	0,	0,	0,	0,	0,	0,	0,	0,	0,	0,	0,	0,	0,	0],
[0,	0,	0,	0,	0,	0,	0,	0,	0,	0,	0,	0,	0,	0,	0,	0,	0,	101,0,	0,	0,	0,	0,	0,	0,	0,	0,	0,	0,	0,	0,	0,	102,0,	0,	0,	0],
[0,	0,	0,	0,	0,	0,	0,	0,	0,	0,	0,	0,	0,	0,	0,	0,	0,	0,	0,	0,	0,	0,	0,	0,	0,	0,	0,	0,	0,	0,	0,	0,	0,	0,	0,	0,	0],	
[0,	0,	0,	0,	0,	0,	0,	0,	0,	0,	0,	0,	0,	0,	0,	0,	0,	0,	0,	0,	0,	0,	0,	101,0,	0,	0,	0,	0,	0,	0,	0,	0,	101,0,	0,	0],
[0,	0,	0,	0,	0,	0,	0,	0,	0,	0,	0,	0,	0,	0,	0,	0,	0,	0,	0,	0,	0,	0,	0,	0,	0,	0,	0,	0,	0,	0,	0,	0,	0,	0,	102,	0,	0],	
[0,	0,	0,	0,	101,0,	0,	0,	0,	0,	0,	0,	0,	0,	0,	0,	0,	0,	0,  0,  0,  0,  0,  0,	0,	0,	0,	0,	0,	0,	0,	0,	0,	0,	0,	0,	0],
[0,	0,	0,	0,	0,	0,	0,	0,	0,	101,0,	0,	0,	0,	0,	0,	0,	0,	0,	0,	0,	0,	0,	0,	0,	0,	0,	0,	101,	202,	0,	101,	0,	0,	0,	0,	0],
[0,	101,0,	0,	0,	0,	0,	0,	0,	0,	0,	0,	301,0,	0,	0,	0,	0,	0,	0,	0,	0,	0,	0,	0,	0,	0,	0,	0,	0,	0,	0,	0,	0,	0,	0,	0],
[0,	103,  0,	0,	0,	0,	0,	0,	0,	0,	0,	0,	0,	0,	0,	0,	0,	0,	0,	0,	0,	0,	0,	0,	0,	0,	0,	0,	0,	0,	0,	0,	0,	0,	102,	0,	0],	
[0,	0,	0,	0,	0,	0,	0,	0,	0,	0,	0,	0,	0,	101,0,	0,	0,	0,	0,	0,	0,	0,	0,	102, 0,	0,	0,	0,	0,	0,	0,	102, 0,	0,	0,	0,	0],
[0,	0,	0,	0,	0,	0,	301,0,	0,	0,	0,	0,	0,	0,	0,	0,	0,	0,	0,	0,	0,	0,	0,	0,	0,	0,	0,	0,	0,	0,	0,	0,	0,	0,	0,	0,	0],
[0,	0,	0,	0,	0,	0,	0,	0,	0,	0,	0,	0,	0,	512,	0,	0,	0,	0,	0,	0,	0,	0,	0,	0,	0,	0,	0,	0,	0,	0,	0,	0,	0,	0,	0,	0,	0],
[0,	0,	0,	0,	0,	0,	0,	0,	0,	0,	0,	0,	0,	0,	0,	0,	0,	0,	0,	0,	0,	0,	0,	0,	513,0,	0,	0,	0,	0,	0,	0,	0,	0,	0,	0,	0],
[0,	0,	0,	0,	0,	0,	0,	0,	0,	0,	0,	0,	0,	0,	0,	0,	0,	0,	0,	0,	102,103,0,	0,	0,	0,	0,	0,	0,	101,0,	0,	0,	0,	0,	0,	0],
[0,	0,	0,	0,	0,	0,	0,	0,	0,	0,	0,	0,	0,	0,	0,	101,0,	0,	0,	0,	0,	0,	0,	0,	0,	0,	0,	0,	0,	0,	0,	0,	1002,0,	101,0,	0],
[0,	0,	301,0,	0,	0,	0,	0,	0,	0,	0,	0,	101,0,	0,	0,	0,	511,0,	0,	0,	0,	0,	0,	0,	0,	0,	0,	0,	0,	0,	0,	0,	0,	0,	0,	0],
[0,	0,	0,	0,	0,	0,	0,	0,	0,	0,	0,	0,	0,	0,	0,	0,	0,	0,	0,	0,	101,0,	0,	101,0,	0,	0,	0,	0,	0,	0,	0,	0,	0,	0,	0,	0],	
[0,	0,	0,	0,	0,	0,	0,	0,	0,	0,	0,	0,	0,	0,	0,	0,	0,	0,	101,0,	0,	0,	0,	0,	0,	0,	101,0,	0,	0,	0,	0,	0,	0,	0,	0,	0],
[0,	0,	0,	0,	0,	0,	0,	101,	0,	0,	0,	0,	0,	0,	0,	0,	0,  0,  0,  0,  0,  0,  0,	0,	0,	0,	0,	0,	101,0,	0,	0,	0,	0,	0,	0,	0],
[0,	0,	0,	0,	0,	0,	0,	0,	0,	0,	0,	0,	0,	0,	0,	0,	0,	0,	0,	0,	0,	0,	0,  0,	0,	0,	0,	0,	0,	0,	101,0,	0,	0,	0,	0,	0],
[0,	0,	0,	0,	0,	0,	301,0,	0,	0,	0,	0,	0,	0,	0,	0,	0,	0,	0,	0,	0,	0,	0,	0,	0,	0,	0,	0,	0,	101,0,	0,	0,	0,	0,	0,	0],
[0,	0,	0,	0,	0,	0,	0,	0,	0,	0,	0,	0,	0,	0,	0,	0,	0,	0,	0,	0,	0,	0,	0,	0,	0,	0,	0,	0,	0,	0,	0,	0,	0,	0,	102, 0,	0],
[0,	0,	0,	0,	0,	0,	0,	0,	0,	0,	0,	0,	0,	0,	0,	0,	0,	0,	0,	1001, 0,	0,	0,	0,	0,	0,	0,	0,	0,	0,	0,	0,	0,	0,	101,0,	0],
[0,	0,	0,	0,	0,	0,	0,	0,	0,	0,	0,	0,	0,	0,	0,	0,	0,	0,	0,	0,	0,	0,	0,	0,	0,	0,	0,	0,	0,	0,	0,	0,	0,	0,	0,	0,	0],
[0,	102, 0,	0,	0,	0,	301,0,	0,	0,	0,	0,	0,	0,	0,	0,	0,	0,	0,	0,	0,	0,	0,	0,	0,	0,	0,	101,	0,	0,	0,	0,	0,	0,	0,	0,	0],
[0,	0,	0,	0,	509,0,	0,	0,	0,	0,	101,0,	0,	0,	0,	0,	0,	0,	0,	0,	0,	0,	0,	0,	0,  0,	0,	0,	0,	0,	0,	0,	0,	301,	0,	0,	0],
[0,	0,	0,	0,	0,	0,	1001,0,	0,	0,	0,	0,	0,	0,	0,	0,	0,	0,	0,	0,	0,	0,	0,	0,	0,	0,	0,	0,	0,	0,	0,	0,	0,	0,	0,	0,	0],
[0,	0,	0,	0,	0,	0,	0,	0,	0,	0,	0,	0,	0,	0,	0,	0,	0,	0,	0,	0,	0,	0,	0,	0,	0,	0,	0,	101,	0,	0,	0,	0,	0,	0,	0,	0,	0],
[0,	101,0,	0,	0,	0,	510,0,	0,	0,	0,	0,	0,	0,	0,	0,	0,	0,	0,	0,	0,	0,	0,	0,	0,	0,	0,	0,	0,	0,	0,	0,	0,	0,	0,	0,	0],	
[0,	0,	0,	0,	0,	0,	0,	0,	101,0,	0,	0,	0,	0,	0,	0,	0,	0,	0,	0,	0,	0,	0,	0,	0,	0,	0,	0,	0,	0,	0,	0,	0,	0,	0,	0,	0],
[0,	0,	0,	0,	0,	0,	0,	0,	0,	0,	0,	0,	0,	101,0,	0,	0,	0,	0,	0,	0,	0,	0,	0,	0,	0,	0,	0,	0,	0,	0,	0,	0,	0,	0,	0,	0],
[0,	0,	0,	0,	0,	0,	0,	0,	0,	0,	0,	0,	0,	0,	0,	0,	0,	0,	101,0,	0,	0,	0,	0,	0,	0,	0,	103,  0,	0,	0,	0,	0,	0,	0,	0,	0],
[0,	0,	0,	0,	0,	0,	0,	0,	0,	0,	0,	0,	0,	0,	0,	0,	0,	0,	0,	0,	0,	0,	514,0,	0,	0,	0,	0,	0,	0,	0,	301,	0,	0,	0,	0,	0],
[0,	0,	0,	0,	0,	0,	0,	0,	0,	0,	0,	0,	0,	0,	0,	0,	0,	0,	0,	0,	0,	0,	0,	0,	0,	0,	0,	102, 0,	0,	0,	0,	0,	0,	0,	0,	0],
[0,	101,0,	0,	0,	0,	0,	0,	103,  0,	101,0,	0,	0,	101,0,	1002,	0,	0,	0,	0,	0,	0,	0,	0,	101,0,	0,	0,	0,	0,	0,	0,	0,	101,	0,	0],
[0, 0,	0,	0,	0,	0,	0,	0,	0,	0,	0,	0,	0,	0,	0,	0,	99,	0,	0,	0,	0,	0,	0,	0,	0,	0,	0,	0,	0,	0,	0,	0,	0,	0,	0,  0,	0],
[0, 0,	0,	0,	0,	0,	0,	0,	0,	0,	0,	0,	0,	0,	0,	0,	0,	0,	0,	0,	0,	0,	0,	0,	0,	0,	0,	0,	0,	0,	0,	0,	0,	0,	0,	0,	0]
]
]
}