[1,	1,	1,	1,	1,	1,	1,	1,	1,	1,	1,	1,	1,	1,	1,	1,	1,	1,	1,	1,	1,	1,	1,	1,	1,	1,	1,	1,	1,	1,	1,	1,	1,	1,	1,	1,	1],
[1,	1,	1,	1,	1,	0,	0,	0,	0,	0,	0,	1,	1,	1,	0,	0,	0,	1,	0,	0,	1,	1,	1,	1,	1,	1,	1,	0,	1,	0,	1,	1,	1,	1,	1,	1,	1],
[0,	0,	0,	1,	1,	0,	1,	1,	1,	1,	0,	0,	1,	1,	0,	1,	0,	0,	0,	0,	0,	0,	1,	1,	1,	1,	0,	0,	1,	0,	0,	1,	1,	1,	1,	1,	1],
[1,	1,	0,	1,	1,	0,	0,	1,	1,	1,	1,	0,	0,	1,	1,	1,	1,	1,	1,	1,	1,	0,	1,	1,	1,	0,	0,	1,	1, 	1,	0,	0,	1,	1,	1,	1,	1],
[1,	1,	0,	1,	1,	1,	0,	0,	1,	1,	1,	1,	0,	0,	1,	1,	1,	1,	1,	1,	0,	0,	1,	1,	1,	0,	1,	1,	1,	1,	1,	0,	0,	1,	1,	1,	1],
[1,	1,	0,	1,	1,	1,	1,	0,	0,	1,	1,	1,	1,	0,	0,	1,	1,	1,	1,	0,	0,	1,	1,	0,	1,	0,	0,	1,	1,	1,	1,	1,	1,	0,	1,	1,	1],
[1,	1,	0,	1,	1,	1,	1,	1,	0,	0,	1,	1,	1,	1,	0,	0,	1,	1,	0,	0,	1,	1,	0,	0,	1,	1,	0,	0,	1,	1,	0,	0,	1,	0,	0,	1,	1],	
[1,	0,	0,	1,	1,	1,	1,	0,	0,	0,	0,	1,	1,	1,	1,	0,	0,	1,	1,	1,	1,	1,	0,	1,	1,	1,	1,	0,	0,	1,	0,	0,	1,	0,	0,	1,	1],
[1,	0,	1,	1,	1,	1,	1,	0,	0,	1,	0,	0,	1,	1,	1,	1,	0,	1,	0,	0,	1,	1,	0,	0,	1,	1,	0,	0,	0,	0,	0,	1,	0,	0,	0,	1,	1],	
[1,	0,	1,	1,	1,	1,	1,	0,	1,	0,	0,	0,	0,	1,	1,	0,	0,	1,	1,  0,  0,  1,  1,  0,	0,	0,	0,	1,	1,	0,	1,	0,	0,	0,	1,	1,	1],
[1,	0,	0,	0,	0,	0,	0,	0,	0,	0,	1,	1,	0,	1,	0,	0,	1,	1,	1,	0,	0,	0,	1,	1,	1,	0,	1,	1,	1,	1,	0,	0,	0,	1,	1,	1,	1],
[1,	0,	0,	0,	0,	0,	0,	0,	0,	1,	1,	0,	0,	1,	0,	1,	1,	0,	0,	0,	0,	0,	0,	1,	0,	0,	1,	1,	1,	0,	0,	0,	1,	1,	1,	1,	1],
[1,	0,	1,	1,	1,	1,	0,	0,	0,	1,	0,	0,	1,	1,	0,	0,	1,	0,	1,	1,	1,	1,	0,	1,	0,	1,	1,	1,	0,	0,	0,	1,	0,	0,	0,	1,	1],	
[1,	0,	1,	1,	1,	1,	1,	1,	0,	0,	0,	1,	0,	1,	1,	0,	0,	0,	1,	1,	1,	0,	0,	1,	0,	1,	1,	0,	0,	0,	1,	0,	0,	1,	0,	1,	1],
[1,	0,	1,	1,	1,	1,	1,	1,	0,	0,	1,	0,	0,	0,	1,	1,	0,	0,	1,	1,	0,	0,	1,	1,	1,	1,	0,	0,	0,	1,	0,	0,	0,	0,	0,	1,	1],
[1,	0,	1,	1,	1,	1,	1,	0,	0,	1,	0,	0,	0,	0,	0,	1,	1,	0,	0,	0,	0,	1,	0,	1,	1,	0,	0,	0,	1,	0,	0,	0,	0,	0,	1,	1,	1],
[1,	0,	1,	1,	1,	0,	0,	0,	1,	0,	0,	1,	1,	1,	0,	0,	1,	1,	0,	0,	1,	1,	0,	0,	1,	0,	0,	1,	0,	0,	1,	0,	0,	0,	1,	1,	1],
[1,	0,	1,	1,	1,	0,	1,	1,	0,	0,	1,	1,	1,	1,	1,	0,	0,	1,	1,	0,	0,	1,	1,	0,	0,	0,	1,	0,	0,	1,	1,	1,	1,	0,	0,	1,	1],
[1,	0,	1,	1,	1,	0,	1,	0,	0,	1,	1,	1,	1,	1,	0,	0,	0,	1,	1,	1,	0,	0,	1,	1,	0,	1,	0,	0,	1,	1,	1,	1,	1,	1,	0,	1,	1],
[1,	0,	1,	1,	1,	0,	1,	0,	0,	0,	0,	0,	0,	0,	0,	1,	0,	0,	1,	1,	1,	0,	0,	0,	1,	0,	0,	1,	1,	1,	1,	1,	1,	0,	0,	1,	1],
[1,	0,	1,	1,	1,	0,	1,	0,	1,	0,	0,	1,	0,	0,	1,	1,	1,	0,	1,	1,	1,	1,	0,	0,	0,	0,	1,	1,	1,	1,	1,	1,	0,	0,	1,	1,	1],	
[1,	0,	1,	1,	1,	0,	1,	0,	1,	0,	0,	0,	1,	0,	0,	1,	1,	0,	1,	1,	1,	0,	0,	1,	1,	0,	0,	1,	0,	0,	1,	1,	0,	1,	1,	1,	1],
[1,	0,	0,	0,	0,	0,	1,	0,	1,	0,	1,	0,	0,	1,	0,	0,	1,  0,  0,  0,  0,  0,  1,	1,	1,	1,	0,	0,	0,	0,	0,	0,	0,	0,	1,	1,	1],
[1,	0,	0,	1,	1,	1,	0,	0,	1,	0,	0,	0,	0,	0,	1,	0,	0,	1,	1,	0,	1,	1,	1, 	1,	1,	1,	1,	0,	1,	1,	0,	0,	1,	0,	0,	1,	1],
[1,	1,	0,	1,	1,	1,	0,	0,	1,	0,	0,	0,	1,	0,	0,	0,	0,	0,	1,	0,	0,	0,	0,	0,	1,	1,	1,	1,	1,	1,	1,	0,	1,	1,	0,	1,	1],
[1,	1,	0,	0,	0,	1,	0,	0,	1,	0,	0,	0,	0,	1,	0,	0,	1,	0,	1,	0,	0,	1,	1,	1,	1,	1,	1,	1,	1,	1,	1,	0,	1,	0,	0,	1,	1],
[1,	1,	0,	1,	1,	1,	0,	0,	1,	0,	0,	0,	1,	0,	0,	1,	0,	0,	1,	1,	1,	1,	1,	0,	1,	1,	1,	1,	1,	0,	0,	1,	0,	0,	1,	1,	1],
[1,	1,	0,	0,	0,	1,	0,	0,	1,	0,	0,	0,	0,	0,	1,	0,	0,	1,	1,	1,	1,	1,	0,	0,	0,	1,	1,	1,	0,	0,	1,	1,	0,	0,	1,	1,	1],
[1,	1,	1,	1,	0,	1,	0,	0,	1,	0,	1,	0,	0,	1,	0,	0,	1,	1,	1,	1,	1,	0,	0,	1,	0,	0,	1,	0,	0,	1,	1,	1,	0,	0,	1,	1,	1],
[1,	1,	1,	1,	0,	0,	0,	0,	1,	1,	0,	0,	1,	0,	0,	1,	1,	1,	1,	1,	0,	0,	1,	1,	1,  0,	1,	0,	1,	1,	1,	1,	1,	0,	0,	1,	1],
[1,	0,	0,	0,	0,	1,	1,	1,	1,	0,	0,	0,	0,	0,	1,	1,	1,	1,	1,	0,	0,	1,	1,	1,	0,	0,	1,	0,	0,	1,	1,	1,	1,	1,	0,	1,	1],
[1,	0,	1,	1,	1,	1,	1,	1,	0,	0,	1,	0,	0,	1,	1,	0,	0,	1,	0,	0,	1,	1,	1,	0,	0,	1,	1,	1,	0,	0,	1,	1,	1,	0,	0,	1,	1],
[1,	0,	0,	0,	0,	0,	0,	0,	0,	1,	0,	0,	1,	1,	0,	0,	0,	0,	0,	1,	1,	1,	0,	0,	1,	1,	1,	1,	1,	0,	0,	1,	0,	0,	1,	1,	1],	
[1,	0,	0,	1,	1,	0,	0,	0,	1,	0,	0,	1,	1,	0,	0,	0,	1,	0,	1,	1,	1,	1,	0,	1,	1,	1,	1,	1,	1,	1,	1,	1,	0,	1,	1,	1,	1],
[1,	0,	1,	1,	1,	0,	0,	1,	1,	0,	1,	1,	1,	0,	1,	0,	1,	0,	0,	0,	0,	0,	0,	0,	1,	1,	1,	1,	1,	0,	0,	1,	0,	0,	1,	1,	1],
[1,	0,	1,	1,	0,	0,	1,	0,	1,	0,	0,	1,	1,	0,	0,	0,	1,	1,	0,	0,	0,	0,	1,	0,	0,	1,	1,	1,	0,	0,	1,	1,	1,	0,	0,	1,	1],
[1,	0,	0,	0,	0,	1,	0,	0,	0,	1,	0,	0,	0,	0,	0,	0,	1,	1,	1,	0,	0,	1,	1,	1,	0,	0,	1,	0,	0,	1,	1,	1,	0,	0,	0,	1,	1],
[1,	1,	1,	1,	1,	0,	0,	1,	0,	1,	1,	0,	0,	0,	0,	0,	0,	1,	0,	0,	0,	1,	1,	1,	1,	0,	0,	0,	1,	1,	1,	0,	0,	0,	0,	1,	1],
[1,	1,	1,	1,	0,	0,	1,	0,	0,	1,	1,	1,	0,	1,	1,	1,	0,	0,	0,	1,	1,	0,	0,	0,	1,	1,	0,	0,	1,	1,	0,	0,	1,	0,	1,	1,	1],
[1,	1,	1,	0,	0,	1,	0,	0,	1,	1,	1,	0,	0,	0,	1,	1,	1,	0,	1,	1,	0,	0,	1,	0,	0,	1,	1,	0,	0,	0,	0,	1,	0,	0,	0,	1,	1],
[1,	1,	0,	0,	1,	0,	0,	1,	1,	1,	0,	0,	1,	0,	0,	1,	1,	1,	1,	0,	0,	1,	1,	1,	0,	0,	1,	0,	0,	0,	0,	0,	0,	1,	0,	1,	1],
[1,	0,	0,	1,	1,	0,	1,	1,	1,	0,	0,	1,	1,	1,	0,	1,	1,	1,	0,	0,	1,	1,	1,	1,	1,	0,	0,	1,	1,	1,	0,	0,	1,	1,	0,	1,	1],
[1,	1,	1,	1,	1,	0,	0,	1,	0,	0,	1,	1,	1,	1,	0,	0,	1,	0,	0,	1,	1,	1,	1,	1,	1,	1,	0,	0,	1,	0,	0,	1,	1,	0,	0,	1,	1],
[1,	0,	1,	1,	1,	1,	0,	0,	0,	1,	1,	1,	1,	1,	1,	0,	0,	0,	1,	1,	1,	1,	1,	1,	1,	1,	1,	0,	0,	0,	1,	1,	1,	1,	1,	1,	1],
[1,	1,	1,	1,	1,	1,	1,	1,	1,	1,	1,	1,	1,	1,	1,	1,	1,	1,	1,	1,	1,	1,	1,	1,	1,	1,	1,	1,	1,	1,	1,	1,	1,	1,	1,	1,	1],
[1,	1,	1,	1,	1,	1,	1,	1,	1,	1,	1,	1,	1,	1,	1,	1,	1,	1,	1,	1,	1,	1,	1,	1,	1,	1,	1,	1,	1,	1,	1,	1,	1,	1,	1,	1,	1]



[1,	1,	1,	1,	1,	1,	1,	1,	1,	1,	1,	1,	1,	1,	1,	1,	1,	1,	1,	1,	1,	1,	1,	1,	1,	1,	1,	1,	1,	1,	1,	1,	1,	1,	1,	1,	1],
[1,	1,	1,	1,	1,	27,	25,	27,	0,	0,	0,	1,	1,	1,	28,	0,	0,	1,	27,	27,	1,	1,	1,	1,	1,	1,	1,	0,	4,	0,	1,	1,	1,	1,	1,	1,	1],
[0,	0,	0,	1,	1,	0,	0,	0,	0	6,	0,	0,	1,	1,	27,	1,	0,	0,	0,	0,	0,	0,	1,	1,	1,	1,	0,	0,	1,	6,	6,	1,	1,	1,	1,	1,	1],
[1,	1,	0,	1,	1,	0,	6,	1,	1,	1,	1,	0,	27,	1,	1,	1,	1,	1,	1,	1,	1,	0,	1,	1,	1,	27,	6,	1,	1, 	1,	0,	28,	1,	1,	1,	1,	1],
[1,	1,	6,	1,	1,	1,	0,	0,	1,	1,	1,	1,	0,	0,	1,	1,	1,	1,	1,	1,	0,	0,	1,	1,	1,	0,	1,	1,	1,	1,	1,	0,	0,	1,	1,	1,	1],
[1,	1,	0,	1,	1,	1,	1,	0,	27,	1,	1,	1,	1,	6,	6,	1,	1,	1,	1,	0,	6,	1,	1,	28,	1,	6,	0,	1,	1,	1,	1,	1,	22,	0,	1,	1,	1],
[1,	1,	6,	1,	1,	1,	1,	1,	6,	6,	1,	1,	1,	1,	0,	6,	1,	1,	0,	0,	1,	1,	27,	0,	1,	1,	0,	0,	1,	1,	27,	28,	1,	0,	0,	1,	1],	
[1,	0,	0,	1,	1,	1,	1,	0,	6,	6,	0,	1,	1,	1,	1,	0,	0,	1,	22,	1,	1,	1,	0,	1,	1,	1,	1,	27,	0,	1,	0,	0,	1,	6,	0,	1,	1],
[1,	0,	1,	1,	1,	1,	1,	0,	0,	1,	6,	0,	1,	1,	1,	1,	0,	1,	0,	0,	1,	1,	0,	0,	1,	1,	0,	0,	0,	0,	0,	1,	0,	6,	0,	1,	1],	
[1,	0,	1,	1,	1,	1,	1,	27,	1,	0,	0,	0,	6,	1,	1,	0,	0,	1,	1,  6,  6,  1,  1,  27,	0,	0,	0,	1,	1,	0,	1,	0,	0,	55,	1,	1,	1],
[1,	0,	29,	6,	6,	0,	0,	0,	0,	6,	1,	1,	6,	1,	0,	0,	1,	1,	1,	6,	6,	0,	1,	1,	1,	0,	1,	1,	1,	1,	0,	0,	0,	1,	1,	1,	1],
[1,	0,	0,	0,	0,	6,	0,	0,	6,	1,	1,	0,	0,	1,	0,	1,	1,	0,	0,	0,	0,	0,	6,	1,	0,	27,	1,	1,	1,	6,	6,	6,	1,	1,	1,	1,	1],
[1,	0,	1,	1,	1,	1,	27,	0,	0,	1,	0,	0,	1,	1,	0,	27,	1,	0,	1,	1,	1,	1,	6,	1,	0,	1,	1,	1,	0,	0,	29,	1,	6,	0,	6,	1,	1],	
[1,	27,	1,	1,	1,	1,	1,	1,	0,	0,	0,	1,	6,	1,	1,	0,	0,	6,	1,	1,	1,	0,	0,	1,	27,	1,	1,	0,	0,	0,	1,	6,	0,	1,	0,	1,	1],
[1,	0,	1,	1,	1,	1,	1,	1,	27,	0,	1,	0,	0,	29,	1,	1,	0,	0,	1,	1,	6,	0,	1,	1,	1,	1,	29,	6,	29,	1,	0,	6,	6,	0,	0,	1,	1],
[1,	6,	1,	1,	1,	1,	1,	0,	0,	1,	0,	0,	6,	0,	0,	1,	1,	6,	0,	6,	6,	1,	0,	1,	1,	0,	6,	0,	1,	0,	0,	6,	0,	6,	1,	1,	1],
[1,	0,	1,	1,	1,	0,	0,	0,	1,	0,	0,	1,	1,	1,	0,	0,	1,	1,	0,	0,	1,	1,	0,	0,	1,	6,	0,	1,	0,	0,	1,	0,	0,	6,	1,	1,	1],
[1,	6,	1,	1,	1,	0,	1,	1,	0,	0,	1,	1,	1,	1,	1,	6,	6,	1,	1,	0,	0,	1,	1,	0,	0,	0,	1,	0,	0,	1,	1,	1,	1,	0,	0,	1,	1],
[1,	6,	1,	1,	1,	0,	1,	0,	6,	1,	1,	1,	1,	1,	0,	0,	0,	1,	1,	1,	0,	0,	1,	1,	0,	1,	0,	0,	1,	1,	1,	1,	1,	1,	0,	1,	1],
[1,	0,	1,	1,	1,	27,	1,	0,	0,	0,	0,	0,	0,	0,	0,	1,	0,	0,	1,	1,	1,	0,	6,	0,	1,	6,	0,	1,	1,	1,	1,	1,	1,	0,	0,	1,	1],
[1,	0,	1,	1,	1,	6,	1,	27,	1,	6,	0,	1,	0,	0,	1,	1,	1,	6,	1,	1,	1,	1,	0,	0,	0,	0,	1,	1,	1,	1,	1,	1,	0,	0,	1,	1,	1],	
[1,	6,	1,	1,	1,	0,	1,	0,	1,	6,	0,	0,	1,	0,	0,	1,	1,	0,	1,	1,	1,	0,	0,	1,	1,	0,	0,	1,	0,	0,	1,	1,	0,	1,	1,	1,	1],
[1,	0,	0,	0,	0,	0,	1,	6,	1,	6,	1,	25,	0,	1,	0,	0,	1,  0,  0,  0,  0,  0,  1,	1,	1,	1,	0,	0,	0,	0,	0,	0,	0,	0,	1,	1,	1],
[1,	27,	0,	1,	1,	1,	0,	6,	1,	0,	0,	0,	0,	0,	1,	27,	6,	1,	1,	6,	1,	1,	1, 	1,	1,	1,	1,	0,	1,	1,	0,	0,	1,	0,	0,	1,	1],
[1,	1,	0,	1,	1,	1,	0,	29,	1,	0,	6,	0,	1,	6,	6,	0,	6,	6,	1,	0,	0,	0,	28,	27,	1,	1,	1,	1,	1,	1,	1,	22,	1,	1,	0,	1,	1],
[1,	1,	0,	0,	27,	1,	0,	6,	1,	27,	6,	0,	25,	1,	55,	6,	1,	0,	1,	0,	0,	1,	1,	1,	1,	1,	1,	1,	1,	1,	0,	0,	1,	0,	0,	1,	1],
[1,	1,	0,	1,	1,	1,	0,	0,	1,	0,	0,	27,	1,	6,	0,	1,	0,	6,	1,	1,	1,	1,	1,	27,	1,	1,	1,	1,	1,	27,	0,	1,	0,	6,	1,	1,	1],
[1,	1,	0,	0,	0,	1,	27,	0,	1,	6,	0,	0,	0,	0,	1,	0,	0,	1,	1,	1,	1,	1,	6,	0,	0,	1,	1,	1,	0,	0,	1,	1,	0,	6,	1,	1,	1],
[1,	1,	1,	1,	27,	1,	0,	0,	1,	0,	1,	0,	27,	1,	0,	0,	1,	1,	1,	1,	1,	0,	0,	1,	0,	27,	1,	28,	0,	1,	1,	1,	0,	0,	1,	1,	1],
[1,	1,	1,	1,	6,	0,	6,	27,	1,	1,	0,	27,	1,	0,	6,	1,	1,	1,	1,	1,	0,	0,	1,	1,	1,  0,	1,	27,	1,	1,	1,	1,	1,	0,	0,	1,	1],
[1,	0,	27,	0,	0,	1,	1,	1,	1,	0,	0,	0,	0,	6,	1,	1,	1,	1,	1,	6,	6,	1,	1,	1,	0,	0,	1,	0,	0,	1,	1,	1,	1,	1,	0,	1,	1],
[1,	6,	1,	1,	1,	1,	1,	1,	0,	0,	1,	0,	27,	1,	1,	27,	25,	1,	0,	0,	1,	1,	1,	6,	0,	1,	1,	1,	27,	0,	1,	1,	1,	0,	0,	1,	1],
[1, 6,	0,	0,	0,	0,	0,	0,	0,	1,	0,	27,	1,	1,	6,	0,	0,	0,	0,	1,	1,	1,	6,	6,	1,	1,	1,	1,	1,	27,	0,	1,	0,	0,	1,	1,	1],	
[1,	25,	0,	1,	1,	27,	0,	0,	1,	0,	0,	1,	1,	6,	0,	0,	1,	0,	1,	1,	1,	1,	6,	1,	1,	1,	1,	1,	1,	1,	22,	1,	0,	1,	1,	1,	1],
[1,	0,	1,	1,	1,	0,	0,	1,	1,	0,	1,	1,	1,	0,	1,	6,	1,	0,	0,	0,	0,	0,	0,	0,	1,	1,	1,	1,	1,	0,	0,	1,	0,	6,	1,	1,	1],
[1,	0,	1,	1,	0,	6,	1,	0,	1,	6,	6,	1,	1,	6,	6,	6,	1,	1,	0,	0,	6,	0,	1,	0,	0,	1,	1,	1,	0,	0,	1,	1,	1,	0,	0,	1,	1],
[1,	27,	0,	0,	0,	1,	0,	0,	0,	1,	0,	0,	0,	27,	0,	6,	1,	1,	1,	0,	6,	1,	1,	1,	0,	0,	1,	0,	0,	1,	1,	1,	0,	29,	0,	1,	1],
[1,	1,	1,	1,	1,	0,	0,	1,	0,	1,	1,	0,	6,	0,	6,	0,	0,	1,	0,	0,	27,	1,	1,	1,	1,	0,	0,	6,	1,	1,	1,	0,	0,	0,	0,	1,	1],
[1,	1,	1,	1,	27,	0,	1,	0,	0,	1,	1,	1,	27,	1,	1,	1,	0,	0,	0,	1,	1,	0,	0,	0,	1,	1,	0,	6,	1,	1,	0,	0,	1,	6,	1,	1,	1],
[1,	1,	1,	0,	6,	1,	6,	0,	1,	1,	1,	0,	0,	0,	1,	1,	1,	0,	1,	1,	0,	0,	1,	0,	0,	1,	1,	0,	0,	0,	0,	1,	0,	6,	6,	1,	1],
[1,	1,	0,	6,	1,	6,	0,	1,	1,	1,	0,	0,	1,	0,	0,	1,	1,	1,	1,	6,	6,	1,	1,	1,	6,	6,	1,	6,	0,	6,	6,	6,	6,	1,	6,	1,	1],
[1,	0,	6,	1,	1,	6,	1,	1,	1,	0,	0,	1,	1,	1,	0,	1,	1,	1,	0,	0,	1,	1,	1,	1,	1,	0,	0,	1,	1,	1,	0,	0,	1,	1,	0,	1,	1],
[1,	24,	1,	1,	1,	0,	0,	1,	0,	0,	1,	1,	1,	1,	0,	0,	1,	0,	0,	1,	1,	1,	1,	1,	1,	1,	0,	0,	1,	0,	0,	1,	1,	0,	0,	1,	1],
[1,	24,	1,	1,	1,	1,	0,	0,	0,	1,	1,	1,	1,	1,	1,	0,	0,	0,	1,	1,	1,	1,	1,	1,	1,	1,	1,	0,	0,	0,	1,	1,	1,	1,	1,	1,	1],
[1,	1,	1,	1,	1,	1,	1,	1,	1,	1,	1,	1,	1,	1,	1,	1,	1,	1,	1,	1,	1,	1,	1,	1,	1,	1,	1,	1,	1,	1,	1,	1,	1,	1,	1,	1,	1],
[1,	1,	1,	1,	1,	1,	1,	1,	1,	1,	1,	1,	1,	1,	1,	1,	1,	1,	1,	1,	1,	1,	1,	1,	1,	1,	1,	1,	1,	1,	1,	1,	1,	1,	1,	1,	1]