{
"type":"map",
"cols": 36,
"rows": 46,
"totalLayers": 2,
"tSize": 64,
"playerLayer": 1,

"tiles":
[
[1,	1,	1,	1,	1,	1,	1,	1,	1,	1,	1,	1,	1,	1,	1,	1,	1,	1,	1,	1,	1,	1,	1,	1,	1,	1,	1,	1,	1,	1,	1,	1,	1,	1,	1,	1,	1],
[1,	1,	1,	1,	1,	0,	0,	0,	0,	0,	0,	1,	1,	1,	0,	0,	0,	1,	0,	0,	1,	1,	1,	1,	1,	1,	1,	0,	1,	0,	1,	1,	1,	1,	1,	1,	1],
[1,	0,	0,	1,	1,	0,	1,	1,	1,	1,	0,	0,	1,	1,	0,	1,	0,	0,	0,	0,	0,	0,	1,	1,	1,	1,	0,	0,	1,	0,	0,	1,	1,	1,	1,	1,	1],
[1,	1,	0,	1,	1,	0,	0,	1,	1,	1,	1,	0,	0,	1,	1,	1,	1,	1,	1,	1,	1,	0,	1,	1,	1,	0,	0,	1,	1, 	1,	0,	0,	1,	1,	1,	1,	1],
[1,	1,	0,	1,	1,	1,	0,	0,	1,	1,	1,	1,	0,	0,	1,	1,	1,	1,	1,	1,	0,	0,	1,	1,	1,	0,	1,	1,	1,	1,	1,	0,	0,	1,	1,	1,	1],
[1,	1,	0,	1,	1,	1,	1,	0,	0,	1,	1,	1,	1,	0,	0,	1,	1,	1,	1,	0,	0,	1,	1,	0,	1,	0,	0,	1,	1,	1,	1,	1,	1,	0,	1,	1,	1],
[1,	1,	0,	1,	1,	1,	1,	1,	0,	0,	1,	1,	1,	1,	0,	0,	1,	1,	0,	0,	1,	1,	0,	0,	1,	1,	0,	0,	1,	1,	0,	0,	1,	0,	0,	1,	1],	
[1,	0,	0,	1,	1,	1,	1,	0,	0,	0,	0,	1,	1,	1,	1,	0,	0,	1,	1,	1,	1,	1,	0,	1,	1,	1,	1,	0,	0,	1,	0,	0,	1,	0,	0,	1,	1],
[1,	0,	1,	1,	1,	1,	1,	0,	0,	1,	0,	0,	1,	1,	1,	1,	0,	1,	0,	0,	1,	1,	0,	0,	1,	1,	0,	0,	0,	0,	0,	1,	0,	0,	0,	1,	1],	
[1,	0,	1,	1,	1,	1,	1,	0,	1,	0,	0,	0,	0,	1,	1,	0,	0,	1,	1,  0,  0,  1,  1,  0,	0,	0,	0,	1,	1,	0,	1,	0,	0,	0,	1,	1,	1],
[1,	0,	0,	0,	0,	0,	0,	0,	0,	0,	1,	1,	0,	1,	0,	0,	1,	1,	1,	0,	0,	0,	1,	1,	1,	0,	1,	1,	1,	1,	0,	0,	0,	1,	1,	1,	1],
[1,	0,	0,	0,	0,	0,	0,	0,	0,	1,	1,	0,	0,	1,	0,	1,	1,	0,	0,	0,	0,	0,	0,	1,	0,	0,	1,	1,	1,	0,	0,	0,	1,	1,	1,	1,	1],
[1,	0,	1,	1,	1,	1,	0,	0,	0,	1,	0,	0,	1,	1,	0,	0,	1,	0,	1,	1,	1,	1,	0,	1,	0,	1,	1,	1,	0,	0,	0,	1,	0,	0,	0,	1,	1],	
[1,	0,	1,	1,	1,	1,	1,	1,	0,	0,	0,	1,	0,	1,	1,	0,	0,	0,	1,	1,	1,	0,	0,	1,	0,	1,	1,	0,	0,	0,	1,	0,	0,	1,	0,	1,	1],
[1,	0,	1,	1,	1,	1,	1,	1,	0,	0,	1,	0,	0,	0,	1,	1,	0,	0,	1,	1,	0,	0,	1,	1,	1,	1,	0,	0,	0,	1,	0,	0,	0,	0,	0,	1,	1],
[1,	0,	1,	1,	1,	1,	1,	0,	0,	1,	0,	0,	0,	0,	0,	1,	1,	0,	0,	0,	0,	1,	0,	1,	1,	0,	0,	0,	1,	0,	0,	0,	0,	0,	1,	1,	1],
[1,	0,	1,	1,	1,	0,	0,	0,	1,	0,	0,	1,	1,	1,	0,	0,	1,	1,	0,	0,	1,	1,	0,	0,	1,	0,	0,	1,	0,	0,	1,	0,	0,	0,	1,	1,	1],
[1,	0,	1,	1,	1,	0,	1,	1,	0,	0,	1,	1,	1,	1,	1,	0,	0,	1,	1,	0,	0,	1,	1,	0,	0,	0,	1,	0,	0,	1,	1,	1,	1,	0,	0,	1,	1],
[1,	0,	1,	1,	1,	0,	1,	0,	0,	1,	1,	1,	1,	1,	0,	0,	0,	1,	1,	1,	0,	0,	1,	1,	0,	1,	0,	0,	1,	1,	1,	1,	1,	1,	0,	1,	1],
[1,	0,	1,	1,	1,	0,	1,	0,	0,	0,	0,	0,	0,	0,	0,	1,	0,	0,	1,	1,	1,	0,	0,	0,	1,	0,	0,	1,	1,	1,	1,	1,	1,	0,	0,	1,	1],
[1,	0,	1,	1,	1,	0,	1,	0,	1,	0,	0,	1,	0,	0,	1,	1,	1,	0,	1,	1,	1,	1,	0,	0,	0,	0,	1,	1,	1,	1,	1,	1,	0,	0,	1,	1,	1],	
[1,	0,	1,	1,	1,	0,	1,	0,	1,	0,	0,	0,	1,	0,	0,	1,	1,	0,	1,	1,	1,	0,	0,	1,	1,	0,	0,	1,	0,	0,	1,	1,	0,	1,	1,	1,	1],
[1,	0,	0,	0,	0,	0,	1,	0,	1,	0,	1,	0,	0,	1,	0,	0,	1,  0,  0,  0,  0,  0,  1,	1,	1,	1,	0,	0,	0,	0,	0,	0,	0,	0,	1,	1,	1],
[1,	0,	0,	1,	1,	1,	0,	0,	1,	0,	0,	0,	0,	0,	1,	0,	0,	1,	1,	0,	1,	1,	1, 	1,	1,	1,	1,	0,	1,	1,	0,	0,	1,	0,	0,	1,	1],
[1,	1,	0,	1,	1,	1,	0,	0,	1,	0,	0,	0,	1,	0,	0,	0,	0,	0,	1,	0,	0,	0,	0,	0,	1,	1,	1,	1,	1,	1,	1,	1,	1,	1,	0,	1,	1],
[1,	1,	0,	0,	0,	1,	0,	0,	1,	0,	0,	0,	0,	1,	0,	0,	1,	0,	1,	0,	0,	1,	1,	1,	1,	1,	1,	1,	1,	1,	1,	0,	1,	0,	0,	1,	1],
[1,	1,	0,	1,	1,	1,	0,	0,	1,	0,	0,	0,	1,	0,	0,	1,	0,	0,	1,	1,	1,	1,	1,	0,	1,	1,	1,	1,	1,	0,	0,	1,	0,	0,	1,	1,	1],
[1,	1,	0,	0,	0,	1,	0,	0,	1,	0,	0,	0,	0,	0,	1,	0,	0,	1,	1,	1,	1,	1,	0,	0,	0,	1,	1,	1,	0,	0,	1,	1,	0,	0,	1,	1,	1],
[1,	1,	1,	1,	0,	1,	0,	0,	1,	0,	1,	0,	0,	1,	0,	0,	1,	1,	1,	1,	1,	0,	0,	1,	0,	0,	1,	0,	0,	1,	1,	1,	0,	0,	1,	1,	1],
[1,	1,	1,	1,	0,	0,	0,	0,	1,	1,	0,	0,	1,	0,	0,	1,	1,	1,	1,	1,	0,	0,	1,	1,	1,  0,	1,	0,	1,	1,	1,	1,	1,	0,	0,	1,	1],
[1,	0,	0,	0,	0,	1,	1,	1,	1,	0,	0,	0,	0,	0,	1,	1,	1,	1,	1,	0,	0,	1,	1,	1,	0,	0,	1,	0,	0,	1,	1,	1,	1,	1,	0,	1,	1],
[1,	0,	1,	1,	1,	1,	1,	1,	0,	0,	1,	0,	0,	1,	1,	0,	0,	1,	0,	0,	1,	1,	1,	0,	0,	1,	1,	1,	0,	0,	1,	1,	1,	0,	0,	1,	1],
[1,	0,	0,	0,	0,	0,	0,	0,	0,	1,	0,	0,	1,	1,	0,	0,	0,	0,	0,	1,	1,	1,	0,	0,	1,	1,	1,	1,	1,	0,	0,	1,	0,	0,	1,	1,	1],	
[1,	0,	0,	1,	1,	0,	0,	0,	1,	0,	0,	1,	1,	0,	0,	0,	1,	0,	1,	1,	1,	1,	0,	1,	1,	1,	1,	1,	1,	1,	1,	1,	0,	1,	1,	1,	1],
[1,	0,	1,	1,	1,	0,	0,	1,	1,	0,	1,	1,	1,	0,	1,	0,	1,	0,	0,	0,	0,	0,	0,	0,	1,	1,	1,	1,	1,	0,	0,	1,	0,	0,	1,	1,	1],
[1,	0,	1,	1,	0,	0,	1,	0,	1,	0,	0,	1,	1,	0,	0,	0,	1,	1,	0,	0,	0,	0,	1,	0,	0,	1,	1,	1,	0,	0,	1,	1,	1,	0,	0,	1,	1],
[1,	0,	0,	0,	0,	1,	0,	0,	0,	1,	0,	0,	0,	0,	0,	0,	1,	1,	1,	0,	0,	1,	1,	1,	0,	0,	1,	0,	0,	1,	1,	1,	0,	0,	0,	1,	1],
[1,	1,	1,	1,	1,	0,	0,	1,	0,	1,	1,	0,	0,	0,	0,	0,	0,	1,	0,	0,	0,	1,	1,	1,	1,	0,	0,	0,	1,	1,	1,	0,	0,	0,	0,	1,	1],
[1,	1,	1,	1,	0,	0,	1,	0,	0,	1,	1,	1,	0,	1,	1,	1,	0,	0,	0,	1,	1,	0,	0,	0,	1,	1,	0,	0,	1,	1,	0,	0,	1,	0,	1,	1,	1],
[1,	1,	1,	0,	0,	1,	0,	0,	1,	1,	1,	0,	0,	0,	1,	1,	1,	0,	1,	1,	0,	0,	1,	0,	0,	1,	1,	0,	0,	0,	0,	1,	0,	0,	0,	1,	1],
[1,	1,	0,	0,	1,	0,	0,	1,	1,	1,	0,	0,	1,	0,	0,	1,	1,	1,	1,	0,	0,	1,	1,	1,	0,	0,	1,	0,	0,	0,	0,	0,	0,	1,	0,	1,	1],
[1,	0,	0,	1,	1,	0,	1,	1,	1,	0,	0,	1,	1,	1,	0,	1,	1,	1,	0,	0,	1,	1,	1,	1,	1,	0,	0,	1,	1,	1,	0,	0,	1,	1,	0,	1,	1],
[1,	1,	1,	1,	1,	0,	0,	1,	0,	0,	1,	1,	1,	1,	0,	0,	1,	0,	0,	1,	1,	1,	1,	1,	1,	1,	0,	0,	1,	0,	0,	1,	1,	0,	0,	1,	1],
[1,	0,	1,	1,	1,	1,	0,	0,	0,	1,	1,	1,	1,	1,	1,	0,	0,	0,	1,	1,	1,	1,	1,	1,	1,	1,	1,	0,	0,	0,	1,	1,	1,	1,	1,	1,	1],
[1,	1,	1,	1,	1,	1,	1,	1,	1,	1,	1,	1,	1,	1,	1,	1,	1,	1,	1,	1,	1,	1,	1,	1,	1,	1,	1,	1,	1,	1,	1,	1,	1,	1,	1,	1,	1],
[1,	1,	1,	1,	1,	1,	1,	1,	1,	1,	1,	1,	1,	1,	1,	1,	1,	1,	1,	1,	1,	1,	1,	1,	1,	1,	1,	1,	1,	1,	1,	1,	1,	1,	1,	1,	1]
],

"layers":
[[
[762,	762,	762,	762,	762,	762,	762,	762,	762,	762,	762,	762,	762,	762,	762,	762,	762,	762,	762,	762,	762,	762,	762,	762,	762,	762,	762,	762,	762,	762,	762,	762,	762,	762,	762,	762,	762],
[762,	762,	762,	762,	762,	1,	1,	1,	1,	1,	1,	762,	762,	762,	1,	1,	1,	762,	1,	1,	762,	762,	762,	762,	762,	762,	762,	1,	1,	1,	762,	762,	762,	762,	762,	762,	762],
[762,	1,	1,	762,	762,	1,	762,	762,	762,	762,	1,	1,	762,	762,	1,	762,	1,	1,	1,	1,	1,	1,	762,	762,	762,	762,	1,	1,	762,	1,	1,	762,	762,	762,	762,	762,	762],
[762,	762,	1,	762,	762,	1,	1,	762,	762,	762,	762,	1,	1,	762,	762,	762,	762,	762,	762,	762,	762,	1,	762,	762,	762,	1,	1,	762,	762, 	762,	1,	1,	762,	762,	762,	762,	762],
[762,	762,	1,	762,	762,	762,	1,	1,	762,	762,	762,	762,	1,	1,	762,	762,	762,	762,	762,	762,	1,	1,	762,	762,	762,	1,	762,	762,	762,	762,	762,	1,	1,	762,	762,	762,	762],
[762,	762,	1,	762,	762,	762,	762,	1,	1,	762,	762,	762,	762,	1,	1,	762,	762,	762,	762,	1,	1,	762,	762,	1,	762,	1,	1,	762,	762,	762,	762,	762,	1,	1,	762,	762,	762],
[762,	762,	1,	762,	762,	762,	762,	762,	1,	1,	762,	762,	762,	762,	1,	1,	762,	762,	1,	1,	762,	762,	1,	1,	762,	762,	1,	1,	762,	762,	1,	1,	762,	1,	1,	762,	762],	
[762,	1,	1,	762,	762,	762,	762,	1,	1,	1,	1,	762,	762,	762,	762,	1,	1,	762,	1,	762,	762,	762,	1,	762,	762,	762,	762,	1,	1,	762,	1,	1,	762,	1,	1,	762,	762],
[762,	1,	762,	762,	762,	762,	762,	1,	1,	762,	1,	1,	762,	762,	762,	762,	1,	762,	1,	1,	762,	762,	1,	1,	762,	762,	1,	1,	1,	1,	1,	762,	1,	1,	1,	762,	762],	
[762,	1,	762,	762,	762,	762,	762,	1,	762,	1,	1,	1,	1,	762,	762,	1,	1,	762,	762,  1,  1,  762,  762,  1,	1,	1,	1,	762,	762,	1,	762,	1,	1,	1,	762,	762,	762],
[762,	1,	1,	1,	1,	1,	1,	1,	1,	1,	762,	762,	1,	762,	1,	1,	762,	762,	762,	1,	1,	1,	762,	762,	762,	1,	762,	762,	762,	762,	1,	1,	1,	762,	762,	762,	762],
[762,	1,	1,	1,	1,	1,	1,	1,	1,	762,	762,	1,	1,	762,	1,	762,	762,	1,	1,	1,	1,	1,	1,	762,	1,	1,	762,	762,	762,	1,	1,	1,	762,	762,	762,	762,	762],
[762,	1,	762,	762,	762,	762,	1,	1,	1,	762,	1,	1,	762,	762,	1,	1,	762,	1,	762,	762,	762,	762,	1,	762,	1,	762,	762,	762,	1,	1,	1,	762,	1,	1,	1,	762,	762],	
[762,	1,	762,	762,	762,	762,	762,	762,	1,	1,	1,	762,	1,	762,	762,	1,	1,	1,	762,	762,	762,	1,	1,	762,	1,	762,	762,	1,	1,	1,	762,	1,	1,	762,	1,	762,	762],
[762,	1,	762,	762,	762,	762,	762,	762,	1,	1,	762,	1,	1,	1,	762,	762,	1,	1,	762,	762,	1,	1,	762,	762,	762,	762,	1,	1,	1,	762,	1,	1,	1,	1,	1,	762,	762],
[762,	1,	762,	762,	762,	762,	762,	1,	1,	762,	1,	1,	1,	1,	1,	762,	762,	1,	1,	1,	1,	762,	1,	762,	762,	1,	1,	1,	762,	1,	1,	1,	1,	1,	762,	762,	762],
[762,	1,	762,	762,	762,	1,	1,	1,	762,	1,	1,	762,	762,	762,	1,	1,	762,	762,	1,	1,	762,	762,	1,	1,	762,	1,	1,	762,	1,	1,	762,	1,	1,	1,	762,	762,	762],
[762,	1,	762,	762,	762,	1,	762,	762,	1,	1,	762,	762,	762,	762,	762,	1,	1,	762,	762,	1,	1,	762,	762,	1,	1,	1,	762,	1,	1,	762,	762,	762,	762,	1,	1,	762,	762],
[762,	1,	762,	762,	762,	1,	762,	1,	1,	762,	762,	762,	762,	762,	1,	1,	1,	762,	762,	762,	1,	1,	762,	762,	1,	762,	1,	1,	762,	762,	762,	762,	762,	762,	1,	762,	762],
[762,	1,	762,	762,	762,	1,	762,	1,	1,	1,	1,	1,	1,	1,	1,	762,	1,	1,	762,	762,	762,	1,	1,	1,	762,	1,	1,	762,	762,	762,	762,	762,	762,	1,	1,	762,	762],
[762,	1,	762,	762,	762,	1,	762,	1,	762,	1,	1,	762,	1,	1,	762,	762,	762,	1,	762,	762,	762,	762,	1,	1,	1,	1,	762,	762,	762,	762,	762,	762,	1,	1,	762,	762,	762],	
[762,	1,	762,	762,	762,	1,	762,	1,	762,	1,	1,	1,	762,	1,	1,	762,	762,	1,	762,	762,	762,	1,	1,	762,	762,	1,	1,	762,	1,	1,	762,	762,	1,	762,	762,	762,	762],
[762,	1,	1,	1,	1,	1,	762,	1,	762,	1,	762,	1,	1,	762,	1,	1,	762,  1,  1,  1,  1,  1,  762,	762,	762,	762,	1,	1,	1,	1,	1,	1,	1,	1,	762,	762,	762],
[762,	1,	1,	762,	762,	762,	1,	1,	762,	1,	1,	1,	1,	1,	762,	1,	1,	762,	762,	762,	762,	762,	762, 	762,	762,	762,	762,	1,	762,	762,	1,	1,	762,	1,	1,	762,	762],
[762,	762,	1,	762,	762,	762,	1,	1,	762,	1,	1,	1,	762,	1,	1,	1,	1,	1,	762,	762,	1,	1,	1,	1,	762,	762,	762,	762,	762,	762,	762,	1,	762,	762,	1,	762,	762],
[762,	762,	1,	1,	1,	762,	1,	1,	762,	1,	1,	1,	1,	762,	1,	1,	762,	1,	762,	1,	1,	762,	762,	762,	762,	762,	762,	762,	762,	762,	1,	1,	762,	1,	1,	762,	762],
[762,	762,	1,	762,	762,	762,	1,	1,	762,	1,	1,	1,	762,	1,	1,	762,	1,	1,	762,	762,	762,	762,	762,	1,	762,	762,	762,	762,	762,	1,	1,	762,	1,	1,	762,	762,	762],
[762,	762,	1,	1,	1,	762,	1,	1,	762,	1,	1,	1,	1,	1,	762,	1,	1,	762,	762,	762,	762,	762,	1,	1,	1,	762,	762,	762,	1,	1,	762,	762,	1,	1,	762,	762,	762],
[762,	762,	762,	762,	1,	762,	1,	1,	762,	1,	762,	1,	1,	762,	1,	1,	762,	762,	762,	762,	762,	1,	1,	762,	1,	1,	762,	1,	1,	762,	762,	762,	1,	1,	762,	762,	762],
[762,	762,	762,	762,	1,	1,	1,	1,	762,	762,	1,	1,	762,	1,	1,	762,	762,	762,	762,	762,	1,	1,	762,	762,	762,  1,	762,	1,	762,	762,	762,	762,	762,	1,	1,	762,	762],
[762,	1,	1,	1,	1,	762,	762,	762,	762,	1,	1,	1,	1,	1,	762,	762,	762,	762,	762,	1,	1,	762,	762,	762,	1,	1,	762,	1,	1,	762,	762,	762,	762,	762,	1,	762,	762],
[762,	1,	762,	762,	762,	762,	762,	762,	1,	1,	762,	1,	1,	762,	762,	1,	1,	762,	1,	1,	762,	762,	762,	1,	1,	762,	762,	762,	1,	1,	762,	762,	762,	1,	1,	762,	762],
[762,	1,	1,	1,	1,	1,	1,	1,	1,	762,	1,	1,	762,	762,	1,	1,	1,	1,	1,	762,	762,	762,	1,	1,	762,	762,	762,	762,	762,	1,	1,	762,	1,	1,	762,	762,	762],	
[762,	1,	1,	762,	762,	1,	1,	1,	762,	1,	1,	762,	762,	1,	1,	1,	762,	1,	762,	762,	762,	762,	1,	762,	762,	762,	762,	762,	762,	762,	1,	762,	1,	762,	762,	762,	762],
[762,	1,	762,	762,	762,	1,	1,	762,	762,	1,	762,	762,	762,	1,	762,	1,	762,	1,	1,	1,	1,	1,	1,	1,	762,	762,	762,	762,	762,	1,	1,	762,	1,	1,	762,	762,	762],
[762,	1,	762,	762,	1,	1,	762,	1,	762,	1,	1,	762,	762,	1,	1,	1,	762,	762,	1,	1,	1,	1,	762,	1,	1,	762,	762,	762,	1,	1,	762,	762,	762,	1,	1,	762,	762],
[762,	1,	1,	1,	1,	762,	1,	1,	1,	762,	1,	1,	1,	1,	1,	1,	762,	762,	762,	1,	1,	762,	762,	762,	1,	1,	762,	1,	1,	762,	762,	762,	1,	1,	1,	762,	762],
[762,	762,	762,	762,	762,	1,	1,	762,	1,	762,	762,	1,	1,	1,	1,	1,	1,	762,	1,	1,	1,	762,	762,	762,	762,	1,	1,	1,	762,	762,	762,	1,	1,	1,	1,	762,	762],
[762,	762,	762,	762,	1,	1,	762,	1,	1,	762,	762,	762,	1,	762,	762,	762,	1,	1,	1,	762,	762,	1,	1,	1,	762,	762,	1,	1,	762,	762,	1,	1,	762,	1,	762,	762,	762],
[762,	762,	762,	1,	1,	762,	1,	1,	762,	762,	762,	1,	1,	1,	762,	762,	762,	1,	762,	762,	1,	1,	762,	1,	1,	762,	762,	1,	1,	1,	1,	762,	1,	1,	1,	762,	762],
[762,	762,	1,	1,	762,	1,	1,	762,	762,	762,	1,	1,	762,	1,	1,	762,	762,	762,	762,	1,	1,	762,	762,	762,	1,	1,	762,	1,	1,	1,	1,	1,	1,	762,	1,	762,	762],
[762,	1,	1,	762,	762,	1,	762,	762,	762,	1,	1,	762,	762,	762,	1,	762,	762,	762,	1,	1,	762,	762,	762,	762,	762,	1,	1,	762,	762,	762,	1,	1,	762,	762,	1,	762,	762],
[762,	1,	762,	762,	762,	1,	1,	762,	1,	1,	762,	762,	762,	762,	1,	1,	762,	1,	1,	762,	762,	762,	762,	762,	762,	762,	1,	1,	762,	1,	1,	762,	762,	1,	1,	762,	762],
[762,	762,	762,	762,	762,	762,	1,	1,	1,	762,	762,	762,	762,	762,	762,	1,	1,	1,	762,	762,	762,	762,	762,	762,	762,	762,	762,	1,	1,	1,	762,	762,	762,	762,	762,	762,	762],
[762,	762,	762,	762,	762,	762,	762,	762,	762,	762,	762,	762,	762,	762,	762,	762,	762,	762,	762,	762,	762,	762,	762,	762,	762,	762,	762,	762,	762,	762,	762,	762,	762,	762,	762,	762,	762],
[762,	762,	762,	762,	762,	762,	762,	762,	762,	762,	762,	762,	762,	762,	762,	762,	762,	762,	762,	762,	762,	762,	762,	762,	762,	762,	762,	762,	762,	762,	762,	762,	762,	762,	762,	762,	762]


],
[
[0,	0,	0,	0,	0,	0,	0,	0,	0,	0,	0,	0,	0,	0,	0,	0,	0,	0,	0,	0,	0,	0,	0,	0,	0,	0,	0,	0,	0,	0,	0,	0,	0,	0,	0,	0,	0],
[0,	0,	0,	0,	0,	101,	1001,	101,	0,	0,	0,	0,	0,	0,	102,	0,	0,	0,	101,	101,	0,	0,	0,	0,	0,	0,	0,	0,	4,	0,	0,	0,	0,	0,	0,	0,	0],
[0,	0,	0,	0,	0,	0,	0,	0,	0,	103,	0,	0,	0,	0,	101,	0,	0,	0,	0,	0,	0,	0,	0,	0,	0,	0,	0,	0,	0,	103,	103,	0,	0,	0,	0,	0,	0],
[0,	0,	0,	0,	0,	0,	103,	0,	0,	0,	0,	0,	101,	0,	0,	0,	0,	0,	0,	0,	0,	0,	0,	0,	0,	101,	103,	0,	0, 	0,	0,	102,	0,	0,	0,	0,	0],
[0,	0,	103,	0,	0,	0,	0,	0,	0,	0,	0,	0,	0,	0,	0,	0,	0,	0,	0,	0,	0,	0,	0,	0,	0,	0,	0,	0,	0,	0,	0,	0,	0,	0,	0,	0,	0],
[0,	0,	0,	0,	0,	0,	0,	0,	101,	0,	0,	0,	0,	103,	103,	0,	0,	0,	0,	0,	103,	0,	0,	102,	0,	103,	0,	0,	0,	0,	0,	0,	1002,	0,	0,	0,	0],
[0,	0,	103,	0,	0,	0,	0,	0,	103,	103,	0,	0,	0,	0,	0,	103,	0,	0,	0,	0,	0,	0,	101,	0,	0,	0,	0,	0,	0,	0,	101,	102,	0,	0,	0,	0,	0],	
[0,	0,	0,	0,	0,	0,	0,	0,	103,	103,	0,	0,	0,	0,	0,	0,	0,	0,	1002,	0,	0,	0,	0,	0,	0,	0,	0,	101,	0,	0,	0,	0,	0,	103,	0,	0,	0],
[0,	0,	0,	0,	0,	0,	0,	0,	0,	0,	103,	0,	0,	0,	0,	0,	0,	0,	0,	0,	0,	0,	0,	0,	0,	0,	0,	0,	0,	0,	0,	0,	0,	103,	0,	0,	0],	
[0,	0,	0,	0,	0,	0,	0,	101,	0,	0,	0,	0,	103,	0,	0,	0,	0,	0,	0,  103,  103,  0,  0,  101,	0,	0,	0,	0,	0,	0,	0,	0,	0,	301,	0,	0,	0],
[0,	0,	303,	103,	103,	0,	0,	0,	0,	103,	0,	0,	103,	0,	0,	0,	0,	0,	0,	103,	103,	0,	0,	0,	0,	0,	0,	0,	0,	0,	0,	0,	0,	0,	0,	0,	0],
[0,	0,	0,	0,	0,	103,	0,	0,	103,	0,	0,	0,	0,	0,	0,	0,	0,	0,	0,	0,	0,	0,	103,	0,	0,	101,	0,	0,	0,	103,	103,	103,	0,	0,	0,	0,	0],
[0,	0,	0,	0,	0,	0,	101,	0,	0,	0,	0,	0,	0,	0,	0,	101,	0,	0,	0,	0,	0,	0,	103,	0,	0,	0,	0,	0,	0,	0,	303,	0,	103,	0,	103,	0,	0],	
[0,	101,	0,	0,	0,	0,	0,	0,	0,	0,	0,	0,	103,	0,	0,	0,	0,	103,	0,	0,	0,	0,	0,	0,	101,	0,	0,	0,	0,	0,	0,	103,	0,	0,	0,	0,	0],
[0,	0,	0,	0,	0,	0,	0,	0,	101,	0,	0,	0,	0,	303,	0,	0,	0,	0,	0,	0,	103,	0,	0,	0,	0,	0,	303,	103,	303,	0,	0,	103,	103,	0,	0,	0,	0],
[0,	103,	0,	0,	0,	0,	0,	0,	0,	0,	0,	0,	103,	0,	0,	0,	0,	103,	0,	103,	103,	0,	0,	0,	0,	0,	103,	0,	0,	0,	0,	103,	0,	103,	0,	0,	0],
[0,	0,	0,	0,	0,	0,	0,	0,	0,	0,	0,	0,	0,	0,	0,	0,	0,	0,	0,	0,	0,	0,	0,	0,	0,	103,	0,	0,	0,	0,	0,	0,	0,	103,	0,	0,	0],
[0,	103,	0,	0,	0,	0,	0,	0,	0,	0,	0,	0,	0,	0,	0,	103,	103,	0,	0,	0,	0,	0,	0,	0,	0,	0,	0,	0,	0,	0,	0,	0,	0,	0,	0,	0,	0],
[0,	103,	0,	0,	0,	0,	0,	0,	103,	0,	0,	0,	0,	0,	0,	0,	0,	0,	0,	0,	0,	0,	0,	0,	0,	0,	0,	0,	0,	0,	0,	0,	0,	0,	0,	0,	0],
[0,	0,	0,	0,	0,	101,	0,	0,	0,	0,	0,	0,	0,	0,	0,	0,	0,	0,	0,	0,	0,	0,	103,	0,	0,	103,	0,	0,	0,	0,	0,	0,	0,	0,	0,	0,	0],
[0,	0,	0,	0,	0,	103,	0,	101,	0,	103,	0,	0,	0,	0,	0,	0,	0,	103,	0,	0,	0,	0,	0,	0,	0,	0,	0,	0,	0,	0,	0,	0,	0,	0,	0,	0,	0],	
[0,	103,	0,	0,	0,	0,	0,	0,	0,	103,	0,	0,	0,	0,	0,	0,	0,	0,	0,	0,	0,	0,	0,	0,	0,	0,	0,	0,	0,	0,	0,	0,	0,	0,	0,	0,	0],
[0,	0,	0,	0,	0,	0,	0,	103,0,	103,0,	1001,	0,	0,	0,	0,	0,  0,  0,  0,  0,  0,  0,	0,	0,	0,	0,	0,	0,	0,	0,	0,	0,	0,	0,	0,	0],
[0,	101,0,	0,	0,	0,	0,	103,0,	0,	0,	0,	0,	0,	0,101,103,0,	0,	0,	0,	0,	0, 	0,	0,	0,	0,	0,	0,	0,	0,	0,	0,	0,	0,	0,	0],
[0,	0,	0,	0,	0,	0,	0,	303,0,	0,	103,0,	0,	103,103,	0,	103,	103,	0,	0,	0,	0,	102,	101,	0,	0,	0,	0,	0,	0,	0,	1002,	0,	0,	0,	0,	0],
[0,	0,	0,	0,	101,	0,	0,	103,	0,	101,	103,	0,	1001,	0,	301,	103,	0,	0,	0,	0,	0,	0,	0,	0,	0,	0,	0,	0,	0,	0,	0,	0,	0,	0,	0,	0,	0],
[0,	0,	0,	0,	0,	0,	0,	0,	0,	0,	0,	101,	0,	103,	0,	0,	0,	103,	0,	0,	0,	0,	0,	101,	0,	0,	0,	0,	0,	101,	0,	0,	0,	103,	0,	0,	0],
[0,	0,	0,	0,	0,	0,	101,	0,	0,	103,	0,	0,	0,	0,	0,	0,	0,	0,	0,	0,	0,	0,	103,	0,	0,	0,	0,	0,	0,	0,	0,	0,	0,	103,	0,	0,	0],
[0,	0,	0,	0,	101,	0,	0,	0,	0,	0,	0,	0,	101,	0,	0,	0,	0,	0,	0,	0,	0,	0,	0,	0,	0,	101,	0,	102,	0,	0,	0,	0,	0,	0,	0,	0,	0],
[0,	0,	0,	0,	103,	0,	103,	101,	0,	0,	0,	101,	0,	0,	103,	0,	0,	0,	0,	0,	0,	0,	0,	0,	0,  0,	0,	101,	0,	0,	0,	0,	0,	0,	0,	0,	0],
[0,	0,	101,	0,	0,	0,	0,	0,	0,	0,	0,	0,	0,	103,	0,	0,	0,	0,	0,	103,	103,	0,	0,	0,	0,	0,	0,	0,	0,	0,	0,	0,	0,	0,	0,	0,	0],
[0,	103,	0,	0,	0,	0,	0,	0,	0,	0,	0,	0,	101,	0,	0,	101,	1001,	0,	0,	0,	0,	0,	0,	103,	0,	0,	0,	0,	101,	0,	0,	0,	0,	0,	0,	0,	0],
[0, 103,	0,	0,	0,	0,	0,	0,	0,	0,	0,	101,	0,	0,	103,	0,	0,	0,	0,	0,	0,	0,	103,	103,	0,	0,	0,	0,	0,	101,	0,	0,	0,	0,	0,	0,	0],	
[0,	1001,	0,	0,	0,	101,	0,	0,	0,	0,	0,	0,	0,	103,	0,	0,	0,	0,	0,	0,	0,	0,	103,	0,	0,	0,	0,	0,	0,	0,	1002,	0,	0,	0,	0,	0,	0],
[0,	0,	0,	0,	0,	0,	0,	0,	0,	0,	0,	0,	0,	0,	0,	103,	0,	0,	0,	0,	0,	0,	0,	0,	0,	0,	0,	0,	0,	0,	0,	0,	0,	103,	0,	0,	0],
[0,	0,	0,	0,	0,	103,	0,	0,	0,	103,	103,	0,	0,	103,	103,	103,	0,	0,	0,	0,	103,	0,	0,	0,	0,	0,	0,	0,	0,	0,	0,	0,	0,	0,	0,	0,	0],
[0,	101,	0,	0,	0,	0,	0,	0,	0,	0,	0,	0,	0,	101,	0,	103,	0,	0,	0,	0,	103,	0,	0,	0,	0,	0,	0,	0,	0,	0,	0,	0,	0,	303,	0,	0,	0],
[0,	0,	0,	0,	0,	0,	0,	0,	0,	0,	0,	0,	103,	0,	103,	0,	0,	0,	0,	0,	101,	0,	0,	0,	0,	0,	0,	103,	0,	0,	0,	0,	0,	0,	0,	0,	0],
[0,	0,	0,	0,	101,	0,	0,	0,	0,	0,	0,	0,	101,	0,	0,	0,	0,	0,	0,	0,	0,	0,	0,	0,	0,	0,	0,	103,	0,	0,	0,	0,	0,	103,	0,	0,	0],
[0,	0,	0,	0,	103,	0,	103,	0,	0,	0,	0,	0,	0,	0,	0,	0,	0,	0,	0,	0,	0,	0,	0,	0,	0,	0,	0,	0,	0,	0,	0,	0,	0,	103,	103,	0,	0],
[0,	0,	0,	103,	0,	103,	0,	0,	0,	0,	0,	0,	0,	0,	0,	0,	0,	0,	0,	103,	103,	0,	0,	0,	103,	103,	0,	103,	0,	103,	103,	103,	103,	0,	103,	0,	0],
[0,	0,	103,	0,	0,	103,	0,	0,	0,	0,	0,	0,	0,	0,	0,	0,	0,	0,	0,	0,	0,	0,	0,	0,	0,	0,	0,	0,	0,	0,	0,	0,	0,	0,	0,	0,	0],
[0,	1002,	0,	0,	0,	0,	0,	0,	0,	0,	0,	0,	0,	0,	0,	0,	0,	0,	0,	0,	0,	0,	0,	0,	0,	0,	0,	0,	0,	0,	0,	0,	0,	0,	0,	0,	0],
[0,	99,	0,	0,	0,	0,	0,	0,	0,	0,	0,	0,	0,	0,	0,	0,	0,	0,	0,	0,	0,	0,	0,	0,	0,	0,	0,	0,	0,	0,	0,	0,	0,	0,	0,	0,	0],
[0,	0,	0,	0,	0,	0,	0,	0,	0,	0,	0,	0,	0,	0,	0,	0,	0,	0,	0,	0,	0,	0,	0,	0,	0,	0,	0,	0,	0,	0,	0,	0,	0,	0,	0,	0,	0],
[0,	0,	0,	0,	0,	0,	0,	0,	0,	0,	0,	0,	0,	0,	0,	0,	0,	0,	0,	0,	0,	0,	0,	0,	0,	0,	0,	0,	0,	0,	0,	0,	0,	0,	0,	0,	0]
]]
}