{
"type":"map",
"cols": 46,
"rows": 42,
"totalLayers": 2,
"tSize": 64,
"playerLayer": 1,

"tiles":
[
[1,	1,	1,	1,	1,	1,	1,	1,	1,	1,	1,	1,	1,	1,	1,	1,	1,	1,	1,	1,	1,	1,	1,	1,	1,	1,	1,	1,	1,	1,	1,	1,	1,	1,	1,	1,	1,	1,	1,	1,	1,	1,	1,	1,	1,	1],
[1,	1,	1,	1,	1,	0,	1,	1,	1,	0,	0,	0,	0,	0,	0,	1,	1,	1,	1,	0,	0,	0,	1,	1,	1,	0,	0,	0,	1,	1,	1,	1,	1,	0,	1,	1,	1,	0,	1,	1,	1,	0,	1,	1,	1,	1],
[1,	1,	0,	1,	0,	0,	0,	1,	0,	0,	1,	1,	1,	1,	0,	1,	1,	1,	0,	0,	1,	0,	0,	1,	1,	0,	1,	0,	0,	1,	1,	1,	0,	0,	0,	1,	0,	0,	0,	1,	0,	0,	0,	1,	1,	1],
[1,	0,	0,	0,	0,	1,	0,	0,	0,	1,	1,	0,	1,	0,	0,	1,	1,	0,	0,	1,	1,	1,	0,	0,	1,	0,	0,	1,	0,	0,	1,	0,	0,	1,	0,	0,	0,	1,	0,	0,	0,	1,	0,	0,	1,	1],
[1,	0,	1,	0,	1,	1,	1,	0,	1,	1,	0,	0,	0,	0,	1,	1,	0,	0,	1,	1,	1,	1,	1,	0,	0,	1,	0,	0,	1,	0,	1,	0,	1,	1,	1,	0,	1,	1,	1,	0,	1,	1,	1,	0,	1,	1],
[1,	0,	0,	1,	1,	1,	1,	1,	1,	0,	0,	1,	0,	1,	1,	0,	0,	1,	1,	1,	1,	1,	1,	1,	0,	0,	1,	0,	0,	1,	1,	1,	1,	1,	1,	1,	1,	1,	1,	1,	1,	1,	0,	0,	1,	1],
[1,	1,	0,	0,	1,	1,	1,	1,	0,	0,	1,	0,	0,	1,	0,	0,	1,	1,	1,	1,	1,	1,	1,	1,	1,	0,	0,	1,	0,	0,	1,	1,	1,	1,	1,	1,	1,	0,	0,	0,	1,	1,	0,	1,	1,	1],
[1,	1,	1,	0,	1,	1,	1,	0,	0,	1,	0,	0,	1,	0,	0,	1,	1,	0,	0,	0,	1,	0,	1,	1,	1,	1,	0,	0,	1,	0,	0,	1,	1,	1,	1,	1,	0,	0,	1,	0,	0,	1,	0,	0,	1,	1],		
[1,	0,	0,	0,	1,	1,	1,	0,	1,	1,	0,	1,	0,	0,	1,	1,	0,	0,	1,	0,	0,	0,	0,	1,	0,	0,	1,	0,	0,	1,	0,	1,	1,	1,	1,	0,	0,	1,	1,	1,	0,	1,	1,	0,	1,	1],
[1,	0,	1,	1,	1,	0,	1,	0,	0,	1,	1,	0,	0,	1,	1,	0,	0,	1,	1,	1,	1,	1,	0,	0,	0,	0,	0,	1,	0,	0,	0,	1,	1,	1,	0,	0,	1,	1,	1,	0,	0,	1,	0,	0,	1,	1],
[1,	0,	0,	1,	1,	0,	1,	1,	0,	0,	0,	0,	1,	1,	0,	0,	1,	1,	1,	0,	1,	1,	1,	0,	1,	1,	0,	0,	1,	1,	1,	1,	1,	0,	0,	1,	1,	1,	1,	0,	1,	1,	0,	1,	1,	1],
[1,	1,	1,	1,	0,	0,	1,	1,	1,	0,	0,	1,	0,	0,	0,	1,	1,	1,	0,	0,	0,	1,	1,	1,	1,	1,	1,	0,	0,	1,	1,	1,	0,	0,	1,	1,	1,	1,	1,	0,	0,	1,	0,	0,	1,	1],
[1,	1,	1,	1,	1,	0,	1,	1,	0,	0,	1,	1,	0,	1,	1,	1,	1,	0,	0,	1,	0,	0,	1,	1,	1,	1,	1,	1,	0,	0,	0,	1,	0,	1,	1,	1,	1,	1,	1,	1,	0,	1,	1,	0,	1,	1],
[1,	1,	1,	1,	1,	1,	1,	0,	0,	0,	0,	1,	0,	0,	1,	1,	1,	0,	1,	1,	1,	0,	0,	1,	1,	1,	1,	1,	1,	0,	1,	1,	1,	1,	1,	1,	1,	1,	1,	0,	0,	1,	0,	0,	1,	1],
[1,	1,	1,	1,	1,	1,	0,	0,	1,	1,	0,	0,	1,	0,	0,	1,	1,	0,	0,	1,	1,	1,	0,	0,	1,	1,	1,	1,	1,	1,	1,	1,	1,	1,	1,	1,	1,	1,	1,	0,	1,	1,	0,	1,	1,	1],
[1,	1,	1,	1,	1,	0,	0,	1,	1,	1,	1,	0,	1,	1,	0,	0,	1,	1,	0,	0,	1,	1,	1,	0,	1,	1,	1,	1,	1,	1,	1,	1,	1,	1,	1,	1,	1,	1,	1,	0,	0,	1,	0,	0,	1,	1],
[1,	1,	1,	1,	0,	0,	1,	1,	1,	1,	0,	0,	1,	1,	1,	0,	0,	1,	1,	0,	0,	1,	0,	0,	0,	1,	1,	1,	1,	1,	1,	1,	1,	0,	1,	1,	1,	1,	1,	1,	0,	1,	1,	0,	1,	1],
[1,	1,	1,	0,	0,	1,	1,	0,	1,	0,	0,	1,	1,	1,	1,	1,	0,	0,	1,	1,	1,	0,	0,	1,	0,	0,	1,	1,	1,	1,	1,	1,	0,	0,	0,	1,	1,	1,	1,	0,	0,	1,	0,	0,	1,	1],
[1,	1,	0,	0,	1,	1,	1,	0,	0,	0,	1,	1,	1,	1,	1,	1,	1,	0,	1,	1,	0,	0,	1,	1,	1,	0,	0,	1,	1,	1,	1,	0,	0,	1,	0,	0,	1,	1,	1,	0,	1,	1,	0,	1,	1,	1],
[0,	0,	0,	1,	1,	1,	1,	1,	0,	1,	1,	1,	1,	1,	1,	1,	0,	0,	1,	1,	0,	1,	1,	1,	1,	1,	0,	0,	1,	1,	1,	1,	1,	1,	1,	0,	0,	1,	1,	0,	0,	1,	0,	0,	1,	1],
[1,	1,	1,	1,	1,	1,	0,	0,	0,	0,	1,	1,	1,	1,	1,	0,	0,	1,	1,	0,	1,	1,	1,	1,	1,	1,	1,	0,	0,	1,	1,	0,	0,	1,	1,	1,	0,	0,	1,	1,	0,	1,	1,	0,	1,	1],
[1,	1,	1,	1,	1,	0,	0,	1,	1,	0,	0,	1,	1,	1,	0,	0,	1,	0,	1,	0,	0,	0,	1,	1,	1,	1,	1,	1,	0,	0,	1,	1,	0,	0,	1,	1,	1,	0,	1,	0,	0,	1,	0,	0,	1,	1],
[1,	1,	1,	1,	0,	0,	1,	1,	1,	1,	0,	0,	0,	0,	0,	1,	0,	0,	0,	0,	1,	0,	0,	1,	1,	1,	1,	1,	1,	0,	0,	1,	1,	0,	1,	1,	1,	0,	1,	0,	1,	1,	0,	1,	1,	1],
[1,	1,	1,	0,	0,	1,	1,	1,	0,	1,	1,	0,	0,	0,	0,	0,	0,	1,	0,	0,	1,	1,	0,	0,	1,	1,	1,	1,	1,	1,	0,	1,	0,	0,	1,	1,	0,	1,	1,	0,	0,	1,	0,	0,	1,	1],
[1,	1,	0,	0,	1,	1,	1,	0,	0,	0,	1,	1,	0,	0,	1,	1,	1,	1,	1,	0,	0,	1,	1,	0,	0,	1,	1,	1,	1,	0,	0,	1,	0,	1,	1,	0,	0,	1,	1,	1,	1,	1,	1,	1,	1,	1],
[1,	0,	0,	1,	1,	1,	0,	0,	1,	0,	1,	1,	1,	0,	0,	1,	1,	1,	1,	1,	0,	1,	1,	1,	0,	1,	1,	1,	0,	0,	1,	1,	0,	1,	0,	0,	1,	1,	0,	0,	0,	1,	1,	1,	1,	1],
[1,	0,	1,	1,	1,	0,	0,	1,	0,	0,	0,	1,	1,	1,	0,	0,	1,	1,	1,	0,	0,	1,	1,	0,	0,	1,	1,	0,	0,	1,	1,	1,	1,	0,	0,	1,	1,	0,	0,	1,	0,	0,	1,	1,	1,	1],
[1,	0,	0,	1,	0,	0,	1,	0,	0,	1,	0,	0,	1,	1,	1,	0,	0,	1,	0,	0,	1,	1,	0,	0,	1,	1,	0,	0,	1,	1,	1,	1,	0,	0,	1,	1,	0,	0,	1,	1,	1,	0,	1,	1,	1,	1],
[1,	1,	0,	0,	0,	1,	0,	0,	1,	1,	1,	0,	0,	1,	1,	1,	0,	0,	0,	1,	0,	0,	0,	1,	1,	0,	0,	1,	1,	1,	1,	0,	0,	1,	1,	1,	0,	1,	1,	1,	0,	0,	1,	1,	1,	1],
[1,	1,	1,	0,	1,	0,	0,	1,	0,	1,	1,	1,	0,	0,	1,	1,	1,	0,	1,	1,	0,	0,	1,	1,	0,	0,	1,	1,	1,	1,	1,	0,	1,	1,	1,	1,	0,	0,	1,	1,	0,	1,	1,	1,	1,	1],
[1,	1,	1,	1,	0,	0,	1,	1,	0,	0,	1,	1,	1,	0,	1,	1,	1,	1,	1,	1,	1,	1,	1,	0,	0,	1,	1,	1,	1,	1,	0,	0,	0,	1,	1,	1,	1,	0,	0,	1,	0,	0,	0,	0,	1,	1],
[1,	1,	1,	0,	0,	1,	1,	1,	1,	0,	0,	1,	0,	0,	0,	1,	1,	1,	1,	1,	1,	1,	0,	0,	1,	1,	1,	1,	1,	1,	0,	1,	0,	0,	1,	1,	1,	1,	0,	0,	1,	1,	1,	0,	1,	1],
[1,	1,	0,	0,	1,	1,	1,	1,	1,	1,	0,	0,	0,	1,	0,	0,	1,	1,	1,	1,	1,	0,	0,	1,	1,	1,	0,	0,	1,	0,	0,	1,	1,	0,	0,	1,	1,	1,	1,	0,	1,	1,	1,	0,	1,	1],
[1,	0,	0,	1,	1,	0,	0,	0,	0,	1,	1,	0,	1,	1,	1,	0,	0,	1,	1,	1,	0,	0,	1,	1,	1,	1,	0,	0,	0,	0,	1,	1,	1,	1,	0,	1,	1,	1,	0,	0,	1,	1,	1,	0,	1,	1],
[1,	0,	1,	1,	1,	0,	1,	1,	0,	0,	1,	1,	1,	1,	1,	1,	0,	0,	1,	0,	0,	1,	1,	1,	1,	1,	0,	0,	0,	1,	1,	1,	1,	0,	0,	0,	1,	0,	0,	1,	1,	1,	1,	0,	1,	1],
[1,	0,	0,	1,	1,	0,	0,	0,	1,	0,	0,	1,	1,	1,	1,	1,	1,	0,	0,	1,	1,	1,	1,	1,	1,	1,	1,	1,	1,	1,	1,	1,	0,	0,	1,	0,	0,	0,	1,	1,	1,	1,	1,	0,	1,	1],
[1,	1,	0,	0,	1,	1,	1,	0,	1,	1,	0,	0,	1,	1,	1,	1,	1,	1,	0,	1,	1,	1,	1,	1,	0,	1,	1,	1,	0,	1,	1,	1,	0,	1,	1,	1,	0,	1,	1,	1,	1,	1,	1,	0,	1,	1],
[1,	1,	1,	0,	0,	1,	0,	0,	1,	1,	1,	0,	0,	1,	0,	0,	1,	1,	0,	1,	1,	1,	1,	0,	0,	0,	1,	0,	0,	0,	1,	0,	0,	0,	1,	0,	0,	1,	1,	0,	0,	1,	1,	0,	1,	1],
[1,	1,	1,	1,	0,	0,	0,	1,	1,	1,	1,	1,	0,	0,	0,	0,	0,	1,	1,	1,	1,	1,	0,	0,	1,	0,	0,	0,	1,	0,	0,	0,	1,	0,	0,	0,	1,	1,	1,	0,	0,	1,	1,	0,	1,	1],
[1,	1,	1,	1,	1,	0,	1,	1,	1,	1,	1,	1,	1,	0,	1,	1,	0,	0,	0,	0,	0,	0,	0,	1,	1,	1,	0,	1,	1,	1,	0,	1,	1,	1,	0,	0,	0,	0,	0,	0,	0,	0,	0,	0,	1,	1],
[1,	1,	1,	1,	1,	1,	1,	1,	1,	1,	1,	1,	1,	1,	1,	1,	1,	1,	1,	1,	1,	1,	1,	1,	1,	1,	1,	1,	1,	1,	1,	1,	1,	1,	1,	1,	1,	1,	1,	1,	1,	1,	1,	1,	1,	1],
[1,	1,	1,	1,	1,	1,	1,	1,	1,	1,	1,	1,	1,	1,	1,	1,	1,	1,	1,	1,	1,	1,	1,	1,	1,	1,	1,	1,	1,	1,	1,	1,	1,	1,	1,	1,	1,	1,	1,	1,	1,	1,	1,	1,	1,	1]
],


"layers":
[[
[731, 731,	731,	731,	731,	731,	731,	731,	731,	731,	731,	731,	731,	731,	731,	731,	731,	731,	731,	731,	731,	731,	731,	731,	731,	731,	731,	731,	731,	731,	731,	731,	731,	731,	731,	731,	731,	731,	731,	731,	731,	731,	731,	731,	731,	731],
[731,	731,	731,	731,	731,	724,	731,	731,	731,	724,	724,	724,	724,	724,	724,	731,	731,	731,	731,	724,	724,	724,	731,	731,	731,	724,  724,	724,	731,	731,	731,	731,	731,	724,	731,	731,	731,	724,	731,	731,	731,	724,	731,	731,	731,	731],
[731,	731,	724,	731,	724,	724,	724,	731,	724,	724,	731,	731,	731,	731,	724,	731,	731,	731,	724,	724,	731,	724,	724,	731,	731,	724,	731,	724,	724,	731,	731,	731,	724,	724,	724,	731,	724,	724,	724,	731,	724,	724,	724,	731,	731,	731],
[731,	724,	724,	724,	724,	731,	724,	724,	724,	731,	731,	724,	731,	724,	724,	731,	731,	724,	724,	731,	731,	731,	724,	724,	731,	724,	724,	731,	724,	724,	731,	724,	724,	731,	724,	724,	724,	731,	724,	724,	724,	731,	724,	724,	731,	731],
[731,	724,	731,	724,	731,	731,	731,	724,	731,	731,	724,	724,	724,	724,	731,	731,	724,	724,	731,	731,	731,	731,	731,	724,	724,	731,	724,	724,	731,	724,	724,	724,	731,	731,	731,	724,	731,	731,	731,	724,	731,	731,	731,	724,	731,	731],
[731,	724,	724,	731,	731,	731,	731,	731,	731,	724,	724,	731,	724,	731,	731,	724,	724,	731,	731,	731,	731,	731,	731,	731,	724,	724,	731,	724,	724,	731,	731,	731,	731,	731,	731,	731,	731,	731,	731,	731,	731,	731,	724,	724,	731,	731],
[731,	731,	724,	724,	731,	731,	731,	731,	724,	724,	731,	724,	724,	731,	724,	724,	731,	731,	731,	731,	731,	731,	731,	731,	731,	724,	724,	731,	724,	724,	731,	731,	731,	731,	731,	731,	731,	724,	724,	724,	731,	731,	724,	731,	731,	731],
[731,	731,	731,	724,	731,	731,	731,	724,	724,	731,	724,	724,	731,	724,	724,	731,	731,	724,	724,	724,	731,	724,	731,	731,	731,	731,	724,	724,	731,	724,	724,	731,	731,	731,	731,	731,	724,	724,	731,	724,	724,	731,	724,	724,	731,	731],		
[731,	724,	724,	724,	731,	731,	731,	724,	731,	731,	724,	731,	724,	724,	731,	731,	724,	724,	731,	724,	724,	724,	724,	731,	724,	724,	731,	724,	724,	731,	724,	731,	731,	731,	731,	724,	724,	731,	731,	731,	724,	731,	731,	724,	731,	731],
[731,	724,	731,	731,	731,	724,	731,	724,	724,	731,	731,	724,	724,	731,	731,	724,	724,	731,	731,	731,	731,	731,	724,	724,	724,	724,	724,	731,	724,	724,	724,	731,	731,	731,	724,	724,	731,	731,	731,	724,	724,	731,	724,	724,	731,	731],
[731,	724,	724,	724,	724,	724,	731,	731,	724,	724,	724,	724,	731,	731,	724,	724,	731,	731,	731,	724,	731,	731,	731,	724,	731,	731,	724,	724,	731,	731,	731,	731,	731,	724,	724,	731,	731,	731,	731,	724,	731,	731,	724,	731,	731,	731],
[731,	731,	731,	731,	724,	724,	731,	731,	731,	724,	724,	731,	724,	724,	724,	731,	731,	731,	724,	724,	724,	731,	731,	731,	731,	731,	731,	724,	724,	731,	731,	731,	724,	724,	731,	731,	731,	731,	731,	724,	724,	731,	724,	724,	731,	731],
[731,	731,	731,	731,	731,	102,	731,	731,	724,	724,	731,	731,	724,	731,	731,	731,	731,	724,	724,	731,	724,	724,	731,	731,	731,	731,	731,	731,	724,	724,	724,	724,	724,	731,	731,	731,	731,	731,	731,	731,	724,	731,	731,	724,	731,	731],
[731,	731,	731,	731,	731,	731,	731,	724,	724,	724,	724,	731,	724,	724,	731,	731,	731,	724,	731,	731,	731,	724,	724,	731,	731,	731,	731,	731,	731,	724,	731,	731,	731,	731,	731,	731,	731,	731,	731,	724,	724,	731,	724,	724,	731,	731],
[731,	731,	731,	731,	731,	731,	724,	724,	731,	731,	724,	724,	731,	724,	724,	731,	731,	724,	724,	731,	731,	731,	724,	724,	731,	731,	731,	731,	731,	731,	731,	731,	731,	731,	731,	731,	731,	731,	731,	724,	731,	731,	724,	731,	731,	731],
[731,	731,	731,	731,	731,	724,	724,	731,	731,	731,	731,	724,	731,	731,	724,	724,	731,	731,	724,	724,	731,	731,	731,	724,	731,	731,	731,	731,	731,	731,	731,	731,	731,	731,	731,	731,	731,	731,	731,	724,	724,	731,	724,  724,	731,	731],
[731,	731,	731,	731,	724,	724,	731,	731,	731,	731,	724,	724,	731,	731,	731,	724,	724,	731,	731,	724,	724,    731,	724,	724,	724,	731,	731,	731,	731,	731,	731,	731,	731,	724,	731,	731,	731,	731,	731,	731,	724,	731,	731,	724,	731,	731],
[731,	731,	731,	724,	724,	731,	731,	724,	731,	724,	724,	731,	731,	731,	731,	731,	724,	724,	731,	731,	731,	724,	724,	731,	724,	724,	731,	731,	731,	731,	731,	731,	724,	724,	724,	731,	731,	731,	731,	724,	724,	731,	724,	724,	731,	731],
[731,	731,	724,	724,	731,	731,	731,	724,	724,	724,	731,	731,	731,	731,	731,	731,	731,	724,	731,	731,	724,	724,	731,	731,	731,	724,	724,	731,	731,	731,	731,	724,	724,	731,	724,	724,	731,	731,	731,	724,	731,	731,	724,	731,	731,	731],
[731,	724,	724,	731,	731,	731,	731,	731,	724,	731,	731,	731,	731,	731,	731,	731,	724,	724,	731,	731,	724,	731,	731,	731,	731,	731,	724,	724,	731,	724,  731,	724,	731,	731,	731,	724,	724,	731,	731,	724,	724, 731,	724,	724,	731,	731],
[731,	731,	731,	731,	731,	731,	724,	724,	724,	724,	731,	731,	731,	731,	731,	724,	724,	731,	731,	724,	724,	731,	731,	731,	731,	731,	731,	724,	724,	731,	731,	724,	724,	731,	731,	731,	724,	724,	731,	731,	724,	731,	731,	724,	731,	731],
[731,	731,	731,	731,	731,	724,	724,	731,	731,	724,	724,	731,	731,	731,	724,	724,	731,	724,	731,	724,	724,	724,	731,	731,	731,	731,	731,	731,	724,	724,	731,	731,	724,	724,	731,	731,	731,	724,	731,	724,	724,	731,	724,	724,	731,	731],
[731,	731,	731,	731,	724,	724,	731,	731,	731,	731,	724,	724,	724,	724,	724,	731,	724,	724,	724,	731,	731,	724,	724,	731,	731,	731,	731,	731,	731,	724,	724,	731,	731,	724,	731,	731,	731,	724,	731,	724,	731,	731,	724,	731,	731,	731],
[731,	731,	731,	724,	724,	731,	731,	731,	724,	731,	731,	724,	724,	724,	724,	724,	724,	731,	724,	724,	731,	731,	724,	724,	731,	731,	731,	731,	731,	731,	724,	731,	724,	724,	731,	731,	724,	731,	731,	724,  724,	731,	724,	724,  731,	731],
[731,	731,	724,	724,	731,	731,	731,	724,	724,	724,	731,	731,	724,	724,	731,	731,	731,	731,	731,	724,	724,	731,	731,	724,	724,	731,	731,	731,	731,	724,	724,	731,	724,	731,	731,	724,	724,	731,	731,	731,	731,	731,	731,	731,	731,	731],
[731,	724,	724,	731,	731,	731,	724,	724,	731,	724,	731,	731,	731,	724,	724,	731,	731,	731,	731,	731,	724,	731,	731,	731,	724,	731,	731,	731,	724,	724,	731,	731,	724,  731,	724,	724,	731,	731,	724,	724,	724,	731,	731,	731,	731,	731],
[731,	724,	731,	731,	731,	724,	724,	731,	724,	724,	724,	731,	731,	731,	724,	724,	731,	731,	731,	724,	724,	731,	731,	724,	724,	731,	731,	724,	724,	731,	731,	731,	731,	724,	724,	731,	731,	724,	724,	731,	724,	724,	731,	731,	731,	731],
[731,	724,	724,	731,	724,	724,	731,	724,	724,	731,	724,	724,	731,	731,	731,	724,	724,	731,	724,	724,	731,	731,	724,	724,	731,	731,	724,	724,	731,	731,	731,	731,	724,	724,	731,	731,	724,	724,	731,	731,	731,	724,	731,	731,	731,	731],
[731,	731,	724,	724,	724,	731,	724,	724,	731,	731,	731,	724,	724,	731,	731,	731,	724,	724,	724,	731,	724,	724,	724,	731,	731,	724,	724,	731,	731,	731,	731,	724,	724,	731,	731,	731,	724,	731,	731,	731,	724,	724,	731,	731,	731,	731],
[731,	731,	731,	724,	731,	724,	724,	731,	724,    731,	731,	731,	724,	724,	731,	731,	731,	724,	731,	731,	724,	724,	731,	731,	724,	724,	731,	731,	731,	731,	731,	724,	731,	731,	731,	731,	724,	724,	731,	731,	724,	731,	731,	731,	731,	731],
[731,	731,	731,	731,	724,	724,	731,	731,	724,	724,	731,	731,	731,	724,	731,	731,	731,	731,	731,	724,    731,	731,	731,	724,	724,	731,	731,	731,	731,	731,	724,	724,	724,	731,	731,	731,	731,	724,	724,	731,	724,	724,	724,	724,	731,	731],
[731,	731,	731,	724,	724,	731,	731,	731,	731,	724,	724,	731,	724,	724,	724,	731,	731,	731,	731,	731,	731,	731,	724,	724,	731,	731,	731,	731,	731,	731,	724,	731,	724,	724,	731,	731,	731,	731,	724,	724,	731,	731,	731,	724,	731,	731],
[731,	731,	724,	724,	731,	731,	731,	731,	731,	731,	724,	724,	724,	731,	724,	724,	731,	731,	731,	731,	731,	724,	724,	731,	731,	731,	724,    724,	731,	724,	724,	731,	731,	724,	724,	731,	731,	731,	731,	724,	731,	731,	731,	724,	731,	731],
[731,	724,	724,	731,	731,	724,	724,	724,	724,	731,	731,	724,	731,	731,	731,	724,	724,	731,	731,	731,	724,	724,	731,	731,	731,	731,	724,    724,	724,	724,	731,	731,	731,	731,	724,	731,	731,	731,	724,	724,	731,	731,	731,	724,	731,	731],
[731,	724,	731,	731,	731,	724,	731,	731,	724,	724,	731,	731,	731,	731,	731,	731,	724,	724,	731,	724,	724,	731,	731,	731,	731,	731,	724,	724,	724,	731,	731,	731,	731,	724,	724,	724,	731,	724,	724,	731,	731,	731,	731,	724,	731,	731],
[731,	724,	724,	731,	731,	724,	724,	724,	731,	724,	724,	731,	731,	731,	731,	731,	731,	724,	724,	724,	731,	731,	731,	731,	731,	731,	731,	731,	731,	731,	731,	731,	724,	724,	731,	724,	724,	724,	731,	731,	731,	731,	731,	724,	731,	731],
[731,	731,	724,	724,	731,	731,	731,	724,	731,	731,	724,	724,	731,	731,	731,	731,	731,	731,	724,	731,	731,	731,	731,	731,	724,	731,	731,	731,	724,	731,	731,	731,	724,	731,	731,	731,	724,	731,	731,	731,	731,	731,	731,	724,	731,	731],
[731,	731,	731,	724,	724,	731,	724,	724,	731,	731,	731,	724,	724,	731,	724,	724,	731,	731,	724,	731,	731,	731,	731,	724,	724,	724,	731,	724,	724,	724,	731,	724,	724,	724,	731,	724,	724,	731,	731,	724,	724,	731,	731,	724,	731,	731],
[731,	731,	731,	731,	724,	724,	724,	731,	731,	731,	731,	731,	724,	724,	724,	724,	724,	731,	731,	731,	731,	731,	724,	724,	731,	724,	724,	724,	731,	724,	724,	724,	731,	724,	724,	724,	731,	731,	731,	724,	724,	731,	731,	724,	731,	731],
[731,	731,	731,	731,	731,	724,	731,	731,	731,	731,	731,	731,	731,	724,	731,	731,	724,	724,	724,	724,	724,	724,	724,	731,	731,	731,	724,	731,	731,	731,	724,	731,	731,	731,	724,	724,	724,	724,	724,	724,	724,	724,	724,	724,	731,	731],
[731,   731,	731,	731,	731,	731,	731,	731,	731,	731,	731,	731,	731,	731,	731,	731,	731,	731,	731,	731,	731,	731,	731,	731,	731,	731,	731,	731,	731,	731,	731,	731,	731,	731,	731,	731,	731,	731,	731,	731,	731,	731,	731,	731,	731,	731],
[731,	731,	731,	731,	731,	731,	731,	731,	731,	731,	731,	731,	731,	731,	731,	731,	731,	731,	731,	731,	731,	731,	731,	731,	731,	731,	731,	731,	731,	731,	731,	731,	731,	731,	731,	731,	731,	731,	731,	731,	731,	731,	731,	731,	731,	731]
],

[
[0, 0,	0,	0,	0,	0,	0,	0,	0,	0,	0,	0,	0,	0,	0,	0,	0,	0,	0,	0,	0,	0,	0,	0,	0,	0,	0,	0,	0,	0,	0,	0,	0,	0,	0,	0,	0,	0,	0,	0,	0,	0,	0,	0,	0,	0],
[0,	0,	0,	0,	0,	103,	0,	0,	0,	0,	103,	0,	0,	103,	103,	0,	0,	0,	0,	0,	0,	103,	0,	0,	0,	6,  101,	103,	0,	0,	0,	0,	0,	101,	0,	0,	0,	101,	0,	0,	0,	101,	0,	0,	0,	0],
[0,	0,	101,	0,	0,	1001,	103,	0,	103,	0,	0,	0,	0,	0,	0,	0,	0,	0,	0,	0,	0,	0,	0,	0,	0,	101,	0,	1001,	0,	0,	0,	0,	103,	103,	0,	0,	0,	0,	0,	0,	0,	0,	0,	0,	0,	0],
[0,	103,	0,	0,	103,	0,	0,	103,	0,	0,	0,	101,	0,	0,	101,	0,	0,	103,	103,	0,	0,	0,	0,	103,	0,	0,	0,	0,	0,	103,	0,	0,	0,	0,	0,	0,	0,	0,	0,	0,	0,	0,	0,	0,	0,	0],
[0,	0,	0,	0,	0,	0,	0,	0,	0,	0,	0,	0,	0,	103,	0,	0,	0,	0,	0,	0,	0,	0,	0,	0,	0,	0,	0,	0,	0,	0,	1002,	0,	0,	0,	0,	103,	0,	0,	0,	0,	0,	0,	0,	0,	0,	0],
[0,	103,	0,	0,	0,	0,	0,	0,	0,	103,	0,	0,	0,	0,	0,	0,	103,	0,	0,	0,	0,	0,	0,	0,	103,	103,	0,	103,	0,	0,	0,	0,	0,	0,	0,	0,	0,	0,	0,	0,	0,	0,	0,	0,	0,	0],
[0,	0,	0,	0,	0,	0,	0,	0,	103,	0,	0,	103,	103,	0,	0,	103,	0,	0,	0,	0,	0,	0,	0,	0,	0,	0,	0,	0,	0,	0,	0,	0,	0,	0,	0,	0,	0,	0,	0,	101,	0,	0,	0,	0,	0,	0],
[0,	0,	0,	0,	0,	0,	0,	0,	0,	0,	0,	0,	0,	0,	0,	0,	0,	103,	0,	0,	0,	103,	0,	0,	0,	0,	0,	0,	0,	0,	0,	0,	0,	0,	0,	0,	0,	0,	0,	0,	0,	0,	0,	0,	0,	0],		
[0,	0,	0,	0,	0,	0,	0,	0,	0,	0,	103,	0,	0,	0,	0,	0,	0,	0,	0,	0,	103,	0,	0,	0,	101,	101,	0,	103,	0,	0,	0,	0,	0,	0,	0,	0,	103,	0,	0,	0,	0,	0,	0,	103,	0,	0],
[0,	0,	0,	0,	0,	0,	0,	103,	0,	0,	0,	0,	0,	0,	0,	0,	0,	0,	0,	0,	0,	0,	0,	103,	0,	0,	0,	0,	0,	0,	0,	0,	0,	0,	0,	0,	0,	0,	0,	103,	0,	0,	0,	0,	0,	0],
[0,	0,	0,	1002,0,	99,	0,	0,	0,	103,	0,	103,	0,	0,	103,	103,	0,	0,	0,	101,	0,	0,	0,	0,	0,	0,	0,	0,	0,	0,	0,	0,	0,	103,	103,	0,	0,	0,	0,	0,	0,	0,	0,	0,	0,	0],
[0,	0,	0,	0,	723,723,	0,	0,	0,	0,	0,	0,	0,	103,	0,	0,	0,	0,	0,	0,	0,	0,	0,	0,	0,	0,	0,	103,	0,	0,	0,	0,	101,	0,	0,	0,	0,	0,	0,	0,	0,	0,	0,	0,	0,	0],
[0,	0,	0,	0,	0,	723,0,	0,	303,	0,	0,	0,	103,	0,	0,	0,	0,	0,	0,	0,	103,	103,	0,	0,	0,	0,	0,	0,	0,	0,	0,	4,	101,	0,	0,	0,	0,	0,	0,	0,	0,	0,	0,	103,	0,	0],
[0,	0,	0,	0,	0,	0,	0,	0,	0,	103,	0,	0,	0,	0,	0,	0,	0,	0,	0,	0,	0,	0,	103,	0,	0,	0,	0,	0,	0,	101,	0,	0,	0,	0,	0,	0,	0,	0,	0,	101,	0,	0,	0,	0,	0,	0],
[0,	0,	0,	0,	0,	0,	0,	0,	0,	0,	0,	0,	0,	0,	0,	0,	0,	103,	103,	0,	0,	0,	0,	103,	0,	0,	0,	0,	0,	0,	0,	0,	0,	0,	0,	0,	0,	0,	0,	0,	0,	0,	0,	0,	0,	0],
[0,	0,	0,	0,	0,	0,	103,	0,	0,	0,	0,	0,	0,	0,	103,	0,	0,	0,	103,	0,	0,	0,	0,	0,	0,	0,	0,	0,	0,	0,	0,	0,	0,	0,	0,	0,	0,	0,	0,	0,	0,	0,	102, 103,	0,	0],
[0,	0,	0,	0,	103,	0,	0,	0,	0,	0,	0,	103,	0,	0,	0,	103,	0,	0,	0,	0,	102, 0,	0,	0,	103,	0,	0,	0,	0,	0,	0,	0,	0,	0,	0,	0,	0,	0,	0,	0,	0,	0,	0,	0,	0,	0],
[0,	0,	0,	103,	0,	0,	0,	101,	0,	0,	0,	0,	0,	0,	0,	0,	0,	0,	0,	0,	0,	103,	103,	0,	0,	103,	0,	0,	0,	0,	0,	0,	103,	0,	0,	0,	101,	0,	0,	103,	0,	0,	0,	0,	0,	0],
[0,	0,	0,	0,	0,	0,	0,	0,	103,	103,	0,	0,	0,	0,	0,	0,	0,	0,	0,	0,	101,	0,	0,	0,	0,	0,	0,	0,	0,	0,	0,	0,	0,	0,	103,	0,	0,	0,	0,	0,	0,	0,	0,	0,	0,	0],
[0,	0,	0,	0,	0,	0,	0,	0,	0,	0,	0,	0,	0,	0,	0,	0,	103,	103,	0,	0,	6,	0,	0,	0,	0,	0,	0,	0,	0,	6,  0,	517,	0,	0,	0,	103,	103,	0,	0,	0,	102, 0,	0,	0,	0,	0],
[0,	0,	0,	0,	0,	0,	103,	0,	103,	0,	0,	0,	0,	0,	0,	103,	0,	0,	0,	101,	0,	0,	0,	0,	0,	0,	0,	0,	0,	0,	0,	0,	103,	0,	0,	0,	0,	0,	0,	0,	0,	0,	0,	103,	0,	0],
[0,	0,	0,	0,	0,	0,	0,	0,	0,	103,	103,	0,	0,	0,	103,	0,	0,	101,	0,	0,	103,	0,	0,	0,	0,	0,	0,	0,	0,	103,	0,	0,	0,	0,	0,	0,	0,	0,	0,	0,	0,	0,	0,	0,	0,	0],
[0,	0,	0,	0,	103,	0,	0,	0,	0,	0,	0,	0,	0,	0,	0,	0,	0,	0,	103,	0,	0,	0,	103,	0,	0,	0,	0,	0,	0,	0,	0,	0,	0,	103,	0,	0,	0,	0,	0,	103,	0,	0,	0,	0,	0,	0],
[0,	0,	0,	0,	0,	0,	0,	0,	101,	0,	0,	103,	0,	0,	0,	0,	0,	0,	0,	0,	0,	0,	0,	103,	0,	0,	0,	0,	0,	0,	0,	0,	0,	0,	0,	0,	103,	0,	0,	6,  101,	0,	101,	6,  0,	0],
[0,	0,	0,	0,	0,	0,	0,	0,	103,	0,	0,	0,	0,	0,	0,	0,	0,	0,	0,	0,	103,	0,	0,	0,	0,	0,	0,	0,	0,	0,	0,	0,	0,	0,	0,	103,	0,	0,	0,	0,	0,	0,	0,	0,	0,	0],
[0,	101,	0,	0,	0,	0,	103,	0,	0,	0,	0,	0,	0,	0,	0,	0,	0,	0,	0,	0,	0,	0,	0,	0,	103,	0,	0,	0,	0,	0,	0,	0,	1001, 0,	0,	0,	0,	0,	0,	0,	0,	0,	0,	0,	0,	0],
[0,	0,	0,	0,	0,	1001,	0,	0,	102,	103,	103,	0,	0,	0,	0,	0,	0,	0,	0,	0,	0,	0,	0,	0,	0,	0,	0,	0,	0,	0,	0,	0,	0,	0,	0,	0,	0,	0,	0,	0,	0,	0,	0,	0,	0,	0],
[0,	103,	0,	0,	103,	0,	0,	0,	0,	0,	0,	0,	0,	0,	0,	103,	103,	0,	103,	0,	0,	0,	0,	0,	0,	0,	0,	103,	0,	0,	0,	0,	103,	0,	0,	0,	0,	0,	0,	0,	0,	0,	0,	0,	0,	0],
[0,	0,	0,	1001,	0,	0,	0,	103,	0,	0,	0,	103,	103,	0,	0,	0,	0,	0,	0,	0,	101,	103,	103,	0,	0,	103,	0,	0,	0,	0,	0,	101,	0,	0,	0,	0,	0,	0,	0,	0,	0,	0,	0,	0,	0,	0],
[0,	0,	0,	0,	0,	0,	0,	0,	102, 0,	0,	0,	0,	0,	0,	0,	0,	101,	0,	0,	0,	101,	0,	0,	0,	0,	0,	0,	0,	0,	0,	0,	0,	0,	0,	0,	103,	0,	0,	0,	0,	0,	0,	0,	0,	0],
[0,	0,	0,	0,	103,	0,	0,	0,	0,	0,	0,	0,	0,	0,	0,	0,	0,	0,	0,	6,  0,	0,	0,	103,	103,	0,	0,	0,	0,	0,	0,	0,	0,	0,	0,	0,	0,	0,	0,	0,	103,	0,	103,	103,	0,	0],
[0,	0,	0,	0,	0,	0,	0,	0,	0,	103,	103,	0,	0,	103,	0,	0,	0,	0,	0,	0,	0,	0,	0,	0,	0,	0,	0,	0,	0,	0,	0,	0,	0,	101,	0,	0,	0,	0,	0,	103,	0,	0,	0,	0,	0,	0],
[0,	0,	0,	0,	0,	0,	0,	0,	0,	0,	0,	0,	0,	0,	0,	0,	0,	0,	0,	0,	0,	0,	0,	0,	0,	0,	102, 0,	0,	103,	0,	0,	0,	0,	0,	0,	0,	0,	0,	0,	0,	0,	0,	0,	0,	0],
[0,	101,	0,	0,	0,	101,	103,	0,	103,	0,	0,	103,	0,	0,	0,	0,	103,	0,	0,	0,	0,	0,	0,	0,	0,	0,	6,  0,	0,	0,	0,	0,	0,	0,	103,	0,	0,	0,	0,	0,	0,	0,	0,	103,	0,	0],
[0,	103,	0,	0,	0,	0,	0,	0,	0,	0,	0,	0,	0,	0,	0,	0,	0,	0,	0,	0,	103,	0,	0,	0,	0,	0,	0,	0,	0,	0,	0,	0,	0,	0,	0,	0,	0,	0,	0,	0,	0,	0,	0,	0,	0,	0],
[0,	0,	103,	0,	0,	0,	0,	103,	0,	103,	103,	0,	0,	0,	0,	0,	0,	103,	0,	1002,	0,	0,	0,	0,	0,	0,	0,	0,	0,	0,	0,	0,	103,	103,	0,	103,	0,	0,	0,	0,	0,	0,	0,	0,	0,	0],
[0,	0,	0,	0,	0,	0,	0,	0,	0,	0,	0,	103,	0,	0,	0,	0,	0,	0,	0,	0,	0,	0,	0,	0,	101,	0,	0,	0,	101,	0,	0,	0,	0,	0,	0,	0,	0,	0,	0,	0,	0,	0,	0,	0,	0,	0],
[0,	0,	0,	0,	0,	0,	0,	103,	0,	0,	0,	0,	0,	0,	101,	101,	0,	0,	101,	0,	0,	0,	0,	103,	0,	0,	0,	0,	0,	103,	0,	0,	0,	103,	0,	0,	103,	0,	0,	101,	0,	0,	0,	0,	0,	0],
[0,	0,	0,	0,	0,	0,	103,	0,	0,	0,	0,	0,	0,	103,	0,	0,	0,	0,	0,	0,	0,	0,	103,	0,	0,	0,	0,	0,	0,	0,	0,	0,	0,	0,	0,	103,	0,	0,	0,	303,	0,	0,	0,	0,	0,	0],
[0,	0,	0,	0,	0,	101,	0,	0,	0,	0,	0,	0,	0,	101,	0,	0,	0,	103,	0,	0,	103,	0,	0,	0,	0,	0,	101,	0,	0,	0,	101,	0,	0,	0,	101,	0,	0,	0,	0,	0,	0,	0,	0,	0,	0,	0],
[0, 0,	0,	0,	0,	0,	0,	0,	0,	0,	0,	0,	0,	0,	0,	0,	0,	0,	0,	0,	0,	0,	0,	0,	0,	0,	0,	0,	0,	0,	0,	0,	0,	0,	0,	0,	0,	0,	0,	0,	0,	0,	0,	0,	0,	0],
[0,	0,	0,	0,	0,	0,	0,	0,	0,	0,	0,	0,	0,	0,	0,	0,	0,	0,	0,	0,	0,	0,	0,	0,	0,	0,	0,	0,	0,	0,	0,	0,	0,	0,	0,	0,	0,	0,	0,	0,	0,	0,	0,	0,	0,	0]
]]
}
