{
"type":"map",
"cols": 48,
"rows": 46,
"totalLayers": 2,
"tSize": 64,
"playerLayer": 1,

"tiles":
[
[1,	1,	1,	1,	1,	1,	1,	1,	1,	1,	1,	1,	1,	1,	1,	1,	1,	1,	1,	1,	1,	1,	1,	1,	1,	1,	1,	1,	1,	1,	1,	1,	1,	1,	1,	1,	1,	1,	1,	1,	1,	1,	1,	1,	1,	1,	1,	1],
[1,	1,	1,	1,	1,	1,	1,	1,	1,	1,	1,	1,	1,	1,	1,	1,	1,	1,	1,	1,	1,	1,	1,	1,	1,	1,	1,	1,	1,	1,	1,	1,	1,	1,	1,	1,	1,	1,	1,	1,	1,	1,	1,	1,	1,	1,	1,	1],
[1,	1,	1,	1,	1,	1,	0,	1,	1,	1,	1,	1,	1,	1,	1,	1,	1,	1,	1,	1,	1,	1,	1,	1,	1,	1,	1,	1,	1,	1,	1,	1,	1,	1,	1,	1,	1,	1,	1,	1,	1,	1,	1,	1,	1,	1,	1,	1],
[1,	0,	0,	0,	1,	0,	1,	1,	1,	1,	1,	1,	1,	1,	1,	1,	1,	1,	1,	1,	1,	1,	1,	1,	1,	1,	1,	1,	1,	1,	1,	1,	1,	1,	1,	1,	1,	1,	1,	1,	1,	1,	1,	0,	0,	0,	1,	1],
[1,	0,	1,	1,	1,	0,	1,	1,	1,	1,	0,	0,	0,	0,	0,	1,	0,	0,	1,	1,	1,	1,	0,	0,	0,	1,	0,	0,	0,	0,	0,	0,	0,	0,	0,	0,	0,	0,	0,	0,	1,	0,	0,	0,	0,	0,	1,	1],
[1,	0,	1,	1,	1,	0,	1,	1,	1,	0,	0,	0,	0,	0,	0,	0,	0,	0,	1,	1,	1,	1,	0,	0,	0,	1,	0,	0,	0,	0,	0,	0,	0,	0,	0,	0,	0,	0,	0,	0,	1,	0,	1,	1,	1,	1,	1,	1],
[1,	0,	0,	1,	0,	0,	0,	0,	1,	0,	1,	1,	1,	1,	1,	1,	1,	0,	1,	0,	0,	1,	0,	0,	0,	0,	0,	1,	1,	1,	1,	1,	1,	1,	1,	1,	1,	1,	1,	0,	1,	0,	1,	1,	1,	1,	1,	1],
[1,	0,	0,	1,	0,	1,	1,	0,	1,	0,	0,	0,	0,	0,	0,	0,	1,	0,	1,	0,	0,	1,	1,	1,	1,	1,	1,	1,	1,	0,	1,	1,	1,	1,	1,	1,	1,	1,	1,	0,	0,	0,	0,	1,	1,	1,	1,	1],
[1,	0,	0,	0,	0,	0,	0,	0,	1,	0,	0,	0,	0,	0,	0,	0,	1,	0,	1,	0,	1,	1,	1,	1,	1,	1,	1,	1,	0,	0,	0,	1,	1,	1,	1,	1,	0,	0,	1,	0,	0,	1,	0,	0,	0,	1,	1,	1],
[1,	1,	0,	1,	1,	1,	0,	1,	1,	1,	1,	1,	1,	1,	1,	1,	1,	0,	1,	0,	0,	1,	1,	1,	1,	0,	0,	0,	0,	1,	0,	0,	1,	1,	1,	1,	0,	0,	1,	1,	1,	1,	1,	1,	0,	0,	1,	1],
[1,	1,	0,	1,	1,	1,	0,	1,	1,	1,	1,	1,	0,	0,	0,	1,	1,	0,	0,	1,	0,	1,	1,	1,	0,	0,	0,	0,	1,	1,	1,	0,	0,	0,	1,	1,	0,	0,	1,	1,	1,	1,	1,	1,	1,	0,	1,	1],
[1,	0,	0,	1,	1,	0,	0,	1,	1,	1,	1,	0,	0,	1,	0,	0,	0,	0,	0,	0,	0,	0,	0,	0,	0,	1,	1,	1,	1,	1,	1,	1,	1,	0,	1,	1,	0,	0,	1,	1,	0,	0,	0,	0,	0,	0,	1,	1],
[1,	0,	0,	1,	1,	0,	1,	1,	1,	1,	0,	0,	1,	1,	1,	0,	0,	1,	1,	1,	0,	0,	0,	0,	1,	1,	1,	1,	1,	1,	1,	1,	1,	0,	0,	0,	0,	0,	0,	0,	0,	0,	0,	0,	0,	0,	1,	1],
[1,	1,	0,	1,	1,	0,	1,	1,	1,	0,	0,	1,	1,	1,	1,	1,	1,	1,	1,	0,	0,	1,	0,	0,	1,	1,	1,	1,	1,	1,	1,	1,	1,	1,	1,	1,	1,	1,	1,	1,	1,	1,	1,	1,	1,	1,	1,	1],
[1,	1,	0,	1,	1,	0,	0,	0,	0,	0,	1,	1,	1,	1,	1,	1,	1,	1,	1,	0,	0,	1,	0,	0,	1,	0,	0,	0,	0,	1,	1,	1,	1,	1,	1,	1,	1,	1,	1,	1,	1,	1,	1,	1,	1,	1,	1,	1],
[1,	0,	0,	1,	1,	0,	0,	1,	1,	1,	1,	1,	1,	0,	0,	0,	1,	0,	0,	0,	0,	1,	0,	1,	1,	0,	0,	0,	0,	0,	0,	0,	0,	0,	0,	0,	0,	0,	0,	0,	0,	1,	1,	1,	1,	1,	1,	1],
[1,	0,	1,	1,	1,	0,	0,	0,	0,	0,	0,	0,	1,	0,	1,	0,	0,	0,	1,	1,	1,	1,	0,	0,	0,	0,	1,	1,	1,	1,	1,	1,	0,	1,	1,	0,	1,	0,	0,	0,	0,	0,	0,	1,	0,	0,	1,	1],
[1,	0,	0,	1,	1,	1,	0,	0,	0,	0,	0,	0,	1,	0,	1,	1,	0,	1,	1,	1,	1,	1,	1,	1,	1,	0,	0,	1,	1,	1,	1,	1,	0,	0,	1,	0,	1,	1,	0,	1,	0,	1,	0,	1,	0,	0,	1,	1],
[1,	1,	0,	1,	1,	1,	0,	0,	0,	1,	1,	0,	1,	0,	0,	1,	1,	1,	1,	1,	1,	1,	1,	1,	1,	0,	0,	1,	1,	1,	1,	1,	0,	0,	0,	0,	1,	1,	1,	0,	0,	1,	1,	1,	1,	0,	1,	1],
[1,	0,	0,	1,	1,	0,	0,	0,	0,	1,	1,	0,	1,	0,	0,	1,	1,	1,	1,	1,	1,	1,	1,	1,	1,	0,	0,	1,	1,	1,	1,	1,	1,	1,	0,	0,	1,	1,	1,	1,	1,	1,	1,	1,	1,	0,	1,	1],
[1,	0,	1,	1,	1,	0,	0,	0,	0,	1,	1,	0,	1,	0,	0,	0,	0,	0,	1,	1,	1,	0,	0,	1,	1,	0,	0,	1,	1,	1,	1,	1,	1,	1,	1,	1,	1,	1,	1,	0,	0,	0,	1,	1,	1,	0,	1,	1],
[1,	0,	0,	1,	1,	0,	0,	1,	1,	0,	0,	0,	1,	0,	0,	0,	0,	0,	1,	1,	1,	0,	0,	1,	1,	0,	0,	1,	1,	0,	0,	0,	0,	0,	0,	1,	1,	0,	0,	0,	1,	0,	1,	1,	1,	0,	1,	1],
[1,	1,	0,	0,	1,	0,	0,	0,	0,	0,	0,	1,	1,	1,	1,	1,	1,	1,	1,	0,	1,	0,	0,	1,	1,	0,	0,	1,	1,	0,	0,	1,	1,	0,	0,	0,	0,	0,	0,	1,	0,	0,	0,	1,	0,	0,	1,	1],
[1,	1,	1,	0,	1,	0,	0,	1,	1,	1,	1,	1,	1,	1,	1,	1,	1,	1,	1,	0,	0,	0,	0,	1,	1,	0,	0,	1,	0,	0,	1,	1,	1,	1,	1,	1,	1,	1,	1,	1,	1,	1,	0,	1,	0,	0,	1,	1],
[1,	1,	0,	0,	1,	0,	1,	1,	1,	1,	1,	1,	1,	1,	1,	1,	1,	1,	1,	1,	1,	1,	0,	1,	0,	0,	0,	1,	0,	1,	1,	1,	0,	0,	0,	1,	1,	1,	1,	1,	1,	1,	0,	1,	0,	0,	1,	1],
[1,	1,	0,	1,	1,	0,	1,	1,	1,	1,	1,	1,	0,	0,	0,	1,	1,	0,	1,	0,	0,	0,	0,	1,	0,	0,	0,	1,	0,	1,	1,	1,	0,	1,	0,	1,	1,	1,	0,	0,	1,	1,	0,	1,	0,	1,	1,	1],
[1,	0,	0,	1,	1,	0,	0,	1,	1,	0,	0,	0,	0,	1,	0,	0,	0,	0,	1,	1,	0,	0,	1,	1,	0,	1,	1,	1,	0,	0,	1,	0,	0,	1,	0,	1,	1,	0,	0,	0,	0,	1,	0,	1,	0,	0,	1,	1],
[1,	0,	1,	1,	1,	1,	0,	1,	1,	0,	1,	1,	1,	1,	1,	1,	1,	0,	0,	1,	0,	0,	1,	1,	0,	1,	1,	1,	1,	0,	1,	0,	1,	1,	0,	1,	1,	0,	1,	1,	0,	0,	0,	1,	1,	1,	1,	1],
[1,	0,	0,	1,	0,	1,	0,	1,	1,	0,	1,	1,	1,	0,	0,	0,	1,	0,	0,	1,	1,	1,	1,	1,	0,	0,	1,	1,	1,	0,	1,	0,	1,	1,	0,	0,	0,	0,	1,	1,	1,	0,	0,	1,	1,	1,	1,	1],
[1,	1,	1,	1,	0,	0,	0,	1,	1,	0,	1,	1,	1,	0,	1,	0,	1,	1,	0,	1,	1,	1,	1,	1,	0,	0,	1,	1,	1,	0,	1,	0,	0,	1,	1,	1,	0,	0,	1,	1,	1,	1,	1,	1,	1,	1,	1,	1],
[1,	1,	1,	1,	0,	0,	1,	1,	1,	0,	1,	0,	0,	0,	1,	0,	1,	1,	0,	1,	1,	1,	1,	1,	1,	0,	1,	1,	1,	0,	1,	1,	0,	1,	1,	1,	1,	1,	1,	1,	1,	0,	0,	0,	0,	1,	1,	1],
[1,	1,	1,	1,	1,	0,	1,	1,	1,	0,	1,	0,	1,	1,	1,	0,	1,	0,	0,	1,	1,	1,	1,	1,	1,	0,	0,	0,	0,	0,	1,	1,	0,	1,	0,	0,	1,	0,	1,	1,	1,	0,	1,	1,	0,	1,	1,	1],
[1,	0,	0,	0,	0,	0,	1,	1,	1,	0,	1,	0,	1,	1,	1,	0,	0,	0,	1,	1,	1,	1,	1,	1,	1,	1,	1,	1,	0,	0,	1,	0,	0,	0,	0,	0,	1,	0,	0,	0,	0,	0,	1,	1,	0,	0,	1,	1],
[1,	0,	0,	0,	0,	0,	1,	1,	1,	0,	1,	0,	1,	1,	1,	1,	1,	1,	1,	0,	0,	1,	1,	1,	1,	1,	1,	1,	1,	0,	1,	1,	1,	1,	1,	0,	0,	0,	0,	1,	1,	1,	1,	1,	1,	0,	1,	1],
[1,	0,	1,	1,	0,	0,	1,	1,	1,	0,	1,	0,	0,	0,	0,	0,	0,	0,	0,	0,	0,	1,	0,	0,	1,	1,	1,	1,	1,	0,	1,	1,	1,	1,	1,	1,	1,	1,	1,	1,	0,	0,	0,	0,	1,	0,	1,	1],
[1,	0,	1,	1,	1,	0,	1,	1,	1,	0,	1,	1,	1,	1,	1,	1,	1,	1,	1,	0,	0,	0,	0,	0,	0,	0,	0,	0,	0,	0,	1,	1,	1,	0,	1,	1,	1,	1,	1,	1,	0,	0,	0,	0,	1,	0,	1,	1],
[1,	0,	0,	1,	1,	0,	1,	1,	1,	0,	1,	1,	1,	1,	1,	1,	1,	1,	1,	1,	1,	1,	1,	1,	1,	0,	1,	0,	0,	1,	1,	0,	0,	0,	0,	0,	0,	1,	1,	1,	0,	1,	0,	0,	1,	0,	1,	1],
[1,	0,	0,	1,	0,	1,	0,	0,	0,	0,	1,	1,	1,	1,	1,	1,	1,	1,	1,	1,	1,	1,	1,	1,	1,	0,	1,	1,	0,	1,	1,	0,	1,	1,	1,	0,	0,	0,	1,	1,	0,	1,	1,	0,	1,	0,	1,	1],
[1,	1,	1,	1,	0,	1,	1,	1,	1,	1,	1,	0,	0,	0,	0,	0,	0,	1,	0,	0,	1,	1,	1,	1,	1,	1,	1,	1,	0,	0,	0,	0,	1,	1,	1,	1,	0,	0,	1,	0,	0,	1,	1,	0,	1,	0,	1,	1],
[1,	1,	1,	1,	0,	1,	1,	0,	1,	1,	1,	0,	1,	0,	0,	1,	0,	0,	0,	0,	1,	1,	1,	1,	1,	0,	1,	1,	1,	0,	1,	1,	1,	1,	1,	1,	0,	1,	1,	0,	0,	1,	1,	0,	1,	0,	1,	1],
[1,	1,	1,	1,	0,	1,	1,	0,	1,	1,	1,	0,	1,	1,	1,	1,	1,	1,	1,	0,	0,	1,	1,	1,	0,	0,	1,	1,	1,	0,	1,	1,	1,	1,	1,	1,	0,	0,	0,	0,	0,	1,	1,	0,	0,	0,	1,	1],
[1,	0,	0,	0,	0,	1,	1,	0,	1,	1,	1,	0,	1,	1,	1,	1,	1,	0,	0,	1,	0,	0,	1,	0,	0,	0,	1,	1,	1,	0,	0,	0,	1,	1,	1,	1,	1,	1,	1,	1,	1,	1,	1,	1,	1,	1,	1,	1],
[1,	1,	1,	1,	0,	1,	1,	0,	1,	1,	1,	0,	0,	1,	1,	0,	0,	1,	0,	0,	1,	0,	0,	0,	1,	1,	1,	1,	1,	1,	0,	0,	1,	1,	0,	0,	1,	0,	0,	0,	1,	0,	0,	0,	0,	0,	1,	1],
[1,	1,	1,	1,	0,	0,	0,	0,	1,	1,	1,	0,	0,	0,	0,	0,	0,	0,	0,	0,	0,	1,	0,	1,	1,	1,	1,	1,	1,	1,	0,	0,	0,	0,	0,	0,	0,	0,	1,	0,	0,	0,	0,	1,	0,	0,	1,	1],
[1,	1,	1,	1,	1,	1,	1,	1,	1,	1,	1,	1,	1,	1,	1,	1,	1,	1,	1,	1,	1,	1,	1,	1,	1,	1,	1,	1,	1,	1,	1,	1,	1,	1,	1,	1,	1,	1,	1,	1,	1,	1,	1,	1,	1,	1,	1,	1],
[1,	1,	1,	1,	1,	1,	1,	1,	1,	1,	1,	1,	1,	1,	1,	1,	1,	1,	1,	1,	1,	1,	1,	1,	1,	1,	1,	1,	1,	1,	1,	1,	1,	1,	1,	1,	1,	1,	1,	1,	1,	1,	1,	1,	1,	1,	1,	1]
],

"layers":

[[
[731,	731,	731,	731,	731,	731,	731,	731,	731,	731,	731,	731,	731,	731,	731,	731,	731,	731,	731,	731,	731,	731,	731,	731,	731,	731,	731,	731,	731,	731,	731,	731,	731,	731,	731,	731,	731,	731,	731,	731,	731,	731,	731,	731,	731,	731,	731,	731],
[731,	731,	731,	731,	731,	731,	731,	731,	731,	731,	731,	731,	731,	731,	731,	731,	731,	731,	731,	731,	731,	731,	731,	731,	731,	731,	731,	731,	731,	731,	731,	731,	731,	731,	731,	731,	731,	731,	731,	731,	731,	731,	731,	731,	731,	731,	731,	731],
[731,	731,	731,	731,	731,	731,	721,	731,	731,	731,	731,	731,	731,	731,	731,	731,	731,	731,	731,	731,	731,	731,	731,	731,	731,	731,	731,	731,	731,	731,	731,	731,	731,	731,	731,	731,	731,	731,	731,	731,	731,	731,	731,	731,	731,	731,	731,	731],
[731,	721,	721,	721,	731,	721,	721,	731,	731,	731,	731,	731,	731,	731,	731,	731,	731,	731,	731,	731,	731,	731,	731,	731,	731,	731,	731,	731,	731,	731,	731,	731,	731,	731,	731,	731,	731,	731,	731,	731,	731,	731,	731,	721,	721,	721,	731,	731],
[731,	721,	731,	731,	731,	721,	731,	731,	731,	731,	721,	721,	721,	721,	721,	731,	721,	721,	731,	731,	731,	731,	721,	721,	721,	731,	721,	721,	721,	721,	721,	721,	721,	721,	721,	721,	721,	721,	721,	721,	731,	721,	721,	721,	721,	721,	731,	731],
[731,	721,	731,	731,	731,	721,	731,	731,	731,	721,	721,	721,	721,	721,	721,	721,	721,	721,	731,	731,	731,	731,	721,	721,	721,	731,	721,	721,	721,	721,	721,	721,	721,	721,	721,	721,	721,	721,	721,	721,	731,	721,	731,	731,	731,	731,	731,	731],
[731,	721,	721,	731,	721,	721,	721,	721,	731,	721,	731,	731,	731,	731,	731,	731,	731,	721,	731,	721,	721,	731,	721,	721,	721,	721,	721,	731,	731,	731,	731,	731,	731,	731,	731,	731,	731,	731,	731,	721,	731,	721,	731,	731,	731,	731,	731,	731],
[731,	721,	721,	731,	721,	731,	731,	721,	731,	721,	721,	721,	721,	721,	721,	721,	731,	721,	731,	721,	721,	731,	731,	731,	731,	731,	731,	731,	731,	721,	731,	731,	731,	731,	731,	731,	731,	731,	731,	721,	721,	721,	721,	731,	731,	731,	731,	731],
[731,	721,	721,	721,	721,	721,	721,	721,	731,	721,	721,	721,	721,	721,	721,	721,	731,	721,	731,	721,	731,	731,	731,	731,	731,	731,	731,	731,	721,	721,	721,	731,	731,	731,	731,	731,	721,	721,	731,	721,	721,	731,	721,	721,	721,	731,	731,	731],
[731,	731,	721,	731,	731,	731,	721,	731,	731,	731,	731,	731,	731,	731,	731,	731,	731,	721,	731,	721,	721,	731,	731,	731,	731,	721,	721,	721,	721,	731,	721,	721,	731,	731,	731,	731,	721,	721,	731,	731,	731,	731,	731,	731,	721,	721,	731,	731],
[731,	731,	721,	731,	731,	731,	721,	731,	731,	731,	731,	731,	721,	721,	721,	731,	731,	721,	721,	731,	721,	731,	731,	731,	721,	721,	721,	721,	731,	731,	731,	721,	721,	721,	731,	731,	721,	721,	731,	731,	731,	731,	731,	731,	731,	721,	731,	731],
[731,	721,	721,	731,	731,	721,	721,	731,	731,	731,	731,	721,	721,	731,	721,	721,	721,	721,	721,	721,	721,	721,	721,	721,	721,	731,	731,	731,	731,	731,	731,	731,	731,	721,	731,	731,	721,	721,	731,	731,	721,	721,	721,	721,	721,	721,	731,	731],
[731,	721,	721,	731,	731,	721,	731,	731,	731,	731,	721,	721,	731,	731,	731,	721,	721,	731,	731,	731,	721,	721,	721,	721,	731,	731,	731,	731,	731,	731,	731,	731,	731,	721,	721,	721,	721,	721,	721,	721,	721,	721,	721,	721,	721,	721,	731,	731],
[731,	731,	721,	731,	731,	721,	731,	731,	731,	721,	721,	731,	731,	731,	731,	731,	731,	731,	731,	721,	721,	731,	721,	721,	731,	731,	731,	731,	731,	731,	731,	731,	731,	731,	731,	731,	731,	731,	731,	731,	731,	731,	731,	731,	731,	731,	731,	731],
[731,	731,	721,	731,	731,	721,	721,	721,	721,	721,	731,	731,	731,	731,	731,	731,	731,	731,	731,	721,	721,	731,	721,	721,	731,	721,	721,	721,	721,	731,	731,	731,	731,	731,	731,	731,	731,	731,	731,	731,	731,	731,	731,	731,	731,	731,	731,	731],
[731,	721,	721,	731,	731,	721,	721,	731,	731,	731,	731,	731,	731,	721,	721,	721,	731,	721,	721,	721,	721,	731,	721,	731,	731,	721,	721,	721,	721,	721,	721,	721,	721,	721,	721,	721,	721,	721,	721,	721,	721,	731,	731,	731,	731,	731,	731,	731],
[731,	721,	731,	731,	731,	721,	721,	721,	721,	721,	721,	721,	731,	721,	731,	721,	721,	721,	731,	731,	731,	731,	721,	721,	721,	721,	731,	731,	731,	731,	731,	731,	721,	731,	731,	721,	731,	721,	721,	721,	721,	721,	721,	721,	721,	721,	731,	731],
[731,	721,	721,	731,	731,	731,	721,	721,	721,	721,	721,	721,	731,	721,	731,	731,	721,	731,	731,	731,	731,	731,	731,	731,	731,	721,	721,	731,	731,	731,	731,	731,	721,	721,	731,	721,	731,	731,	721,	731,	721,	731,	721,	731,	721,	721,	731,	731],
[731,	731,	721,	731,	731,	731,	721,	721,	721,	731,	731,	721,	731,	721,	721,	731,	731,	731,	731,	731,	731,	731,	731,	731,	731,	721,	721,	731,	731,	731,	731,	731,	721,	721,	721,	721,	731,	731,	731,	721,	721,	731,	731,	731,	731,	721,	731,	731],
[731,	721,	721,	731,	731,	721,	721,	721,	721,	731,	731,	721,	731,	721,	721,	731,	731,	731,	731,	731,	731,	731,	731,	731,	731,	721,	721,	731,	731,	731,	731,	731,	731,	731,	721,	721,	731,	731,	731,	731,	731,	731,	731,	731,	731,	721,	731,	731],
[731,	721,	731,	731,	731,	721,	721,	721,	721,	731,	731,	721,	731,	721,	721,	721,	721,	721,	731,	731,	731,	721,	721,	731,	731,	721,	721,	731,	731,	731,	731,	731,	731,	731,	731,	731,	731,	731,	731,	721,	721,	721,	731,	731,	731,	721,	731,	731],
[731,	721,	721,	731,	731,	721,	721,	731,	731,	721,	721,	721,	731,	721,	721,	721,	721,	721,	731,	731,	731,	721,	721,	731,	731,	721,	721,	731,	731,	721,	721,	721,	721,	721,	721,	731,	731,	721,	721,	721,	731,	721,	731,	731,	731,	721,	731,	731],
[731,	731,	721,	721,	731,	721,	721,	721,	721,	721,	721,	731,	731,	731,	731,	731,	731,	731,	731,	721,	731,	721,	721,	731,	731,	721,	721,	731,	731,	721,	721,	731,	731,	721,	721,	721,	721,	721,	721,	731,	721,	721,	721,	731,	721,	721,	731,	731],
[731,	731,	731,	721,	731,	721,	721,	731,	731,	731,	731,	731,	731,	731,	731,	731,	731,	731,	731,	721,	721,	721,	721,	731,	731,	721,	721,	731,	721,	721,	731,	731,	731,	731,	731,	731,	731,	731,	731,	731,	731,	731,	721,	731,	721,	721,	731,	731],
[731,	731,	721,	721,	731,	721,	731,	731,	731,	731,	731,	731,	731,	731,	731,	731,	731,	731,	731,	731,	731,	731,	721,	731,	721,	721,	721,	731,	721,	731,	731,	731,	721,	721,	721,	731,	731,	731,	731,	731,	731,	731,	721,	731,	721,	721,	731,	731],
[731,	731,	721,	731,	731,	721,	731,	731,	731,	731,	731,	731,	721,	721,	721,	731,	731,	721,	721,	721,	721,	721,	721,	731,	721,	721,	721,	731,	721,	731,	731,	731,	721,	731,	721,	731,	731,	731,	721,	721,	731,	731,	721,	731,	721,	731,	731,	731],
[731,	721,	721,	731,	731,	721,	721,	731,	731,	721,	721,	721,	721,	731,	721,	721,	721,	721,	731,	731,	721,	721,	731,	731,	721,	731,	731,	731,	721,	721,	731,	721,	721,	731,	721,	731,	731,	721,	721,	721,	721,	731,	721,	731,	721,	721,	731,	731],
[731,	721,	731,	731,	731,	731,	721,	731,	731,	721,	731,	731,	731,	731,	731,	731,	731,	721,	721,	731,	721,	721,	731,	731,	721,	731,	731,	731,	731,	721,	731,	721,	731,	731,	721,	731,	731,	721,	731,	731,	721,	721,	721,	731,	731,	731,	731,	731],
[731,	721,	721,	731,	721,	731,	721,	731,	731,	721,	731,	731,	731,	721,	721,	721,	731,	721,	721,	731,	731,	731,	731,	731,	721,	721,	731,	731,	731,	721,	731,	721,	731,	731,	721,	721,	721,	721,	731,	731,	731,	721,	721,	731,	731,	731,	731,	731],
[731,	731,	731,	731,	721,	721,	721,	731,	731,	721,	731,	731,	731,	721,	731,	721,	731,	731,	721,	731,	731,	731,	731,	731,	721,	721,	731,	731,	731,	721,	731,	721,	721,	731,	731,	731,	721,	721,	731,	731,	731,	731,	731,	731,	731,	731,	731,	731],
[731,	731,	731,	731,	721,	721,	731,	731,	731,	721,	731,	721,	721,	721,	731,	721,	731,	731,	721,	731,	731,	731,	731,	731,	731,	721,	731,	731,	731,	721,	731,	731,	721,	731,	731,	731,	731,	731,	731,	731,	731,	721,	721,	721,	721,	731,	731,	731],
[731,	731,	731,	731,	731,	721,	731,	731,	731,	721,	731,	721,	731,	731,	731,	721,	731,	721,	721,	731,	731,	731,	731,	731,	731,	721,	721,	721,	721,	721,	731,	731,	721,	731,	721,	721,	731,	721,	731,	731,	731,	721,	731,	731,	721,	731,	731,	731],
[731,	721,	721,	721,	721,	721,	731,	731,	731,	721,	731,	721,	731,	731,	731,	721,	721,	721,	731,	731,	731,	731,	731,	731,	731,	731,	731,	731,	721,	721,	731,	721,	721,	721,	721,	721,	731,	721,	721,	721,	721,	721,	731,	731,	721,	721,	731,	731],
[731,	721,	721,	721,	721,	721,	731,	731,	731,	721,	731,	721,	731,	731,	731,	731,	731,	731,	731,	721,	721,	731,	731,	731,	731,	731,	731,	731,	731,	721,	731,	731,	731,	731,	731,	721,	721,	721,	721,	731,	731,	731,	731,	731,	731,	721,	731,	731],
[731,	721,	731,	731,	721,	721,	731,	731,	731,	721,	731,	721,	721,	721,	721,	721,	721,	721,	721,	721,	721,	731,	721,	721,	731,	731,	731,	731,	731,	721,	731,	731,	731,	731,	731,	731,	731,	731,	731,	731,	721,	721,	721,	721,	731,	721,	731,	731],
[731,	721,	731,	731,	731,	721,	731,	731,	731,	721,	731,	731,	731,	731,	731,	731,	731,	731,	731,	721,	721,	721,	721,	721,	721,	721,	721,	721,	721,	721,	731,	731,	731,	721,	731,	731,	731,	731,	731,	731,	721,	721,	721,	721,	731,	721,	731,	731],
[731,	721,	721,	731,	731,	721,	731,	731,	731,	721,	731,	731,	731,	731,	731,	731,	731,	731,	731,	731,	731,	731,	731,	731,	731,	721,	731,	721,	721,	731,	731,	721,	721,	721,	721,	721,	721,	731,	731,	731,	721,	731,	721,	721,	731,	721,	731,	731],
[731,	721,	721,	731,	721,	721,	721,	721,	721,	721,	731,	731,	731,	731,	731,	731,	731,	731,	731,	731,	731,	731,	731,	731,	731,	721,	731,	731,	721,	731,	731,	721,	731,	731,	731,	721,	721,	721,	731,	731,	721,	731,	731,	721,	731,	721,	731,	731],
[731,	731,	731,	731,	721,	731,	731,	721,	731,	731,	731,	721,	721,	721,	721,	721,	721,	731,	721,	721,	731,	731,	731,	731,	731,	721,	731,	731,	721,	721,	721,	721,	731,	731,	731,	731,	721,	721,	731,	721,	721,	731,	731,	721,	731,	721,	731,	731],
[731,	731,	731,	731,	721,	731,	731,	721,	731,	731,	731,	721,	731,	721,	721,	731,	721,	721,	721,	721,	731,	731,	731,	731,	731,	721,	731,	731,	731,	721,	731,	731,	731,	731,	731,	731,	721,	731,	731,	721,	721,	731,	731,	721,	731,	721,	731,	731],
[731,	731,	731,	731,	721,	731,	731,	721,	731,	731,	731,	721,	731,	731,	731,	731,	731,	731,	731,	721,	721,	731,	731,	731,	721,	721,	731,	731,	731,	721,	731,	731,	731,	731,	731,	731,	721,	721,	721,	721,	721,	731,	731,	721,	721,	721,	731,	731],
[731,	721,	721,	721,	721,	731,	731,	721,	731,	731,	731,	721,	731,	731,	731,	731,	731,	721,	721,	731,	721,	721,	731,	721,	721,	721,	731,	731,	731,	721,	721,	721,	731,	731,	731,	731,	731,	731,	731,	731,	731,	731,	731,	731,	731,	731,	731,	731],
[731,	731,	731,	731,	721,	731,	731,	721,	731,	731,	731,	721,	721,	731,	731,	721,	721,	731,	721,	721,	731,	721,	721,	721,	731,	731,	731,	731,	731,	731,	721,	721,	731,	731,	721,	721,	731,	721,	721,	721,	731,	721,	721,	721,	721,	721,	731,	731],
[731,	731,	731,	731,	721,	721,	721,	721,	731,	731,	731,	721,	721,	721,	721,	721,	721,	721,	721,	721,	721,	731,	721,	731,	731,	731,	731,	731,	731,	731,	721,	721,	721,	721,	721,	721,	721,	721,	731,	721,	721,	721,	721,	731,	721,	721,	731,	731],
[731,	731,	731,	731,	731,	731,	731,	731,	731,	731,	731,	731,	731,	731,	731,	731,	731,	731,	731,	731,	731,	731,	731,	731,	731,	731,	731,	731,	731,	731,	731,	731,	731,	731,	731,	731,	731,	731,	731,	731,	731,	731,	731,	731,	731,	731,	731,	731],
[731,	731,	731,	731,	731,	731,	731,	731,	731,	731,	731,	731,	731,	731,	731,	731,	731,	731,	731,	731,	731,	731,	731,	731,	731,	731,	731,	731,	731,	731,	731,	731,	731,	731,	731,	731,	731,	731,	731,	731,	731,	731,	731,	731,	731,	731,	731,	731]
],
[
[0,	0,	0,	0,	0,	0,	0,	0,	0,	0,	0,	0,	0,	0,	0,	0,	0,	0,	0,	0,	0,	0,	0,	0,	0,	0,	0,	0,	0,	0,	0,	0,	0,	0,	0,	0,	0,	0,	0,	0,	0,	0,	0,	0,	0,	0,	0,	0],
[0,	0,	0,	0,	0,	0,	0,	0,	0,	0,	0,	0,	0,	0,	0,	0,	0,	0,	0,	0,	0,	0,	0,	0,	0,	0,	0,	0,	0,	0,	0,	0,	0,	0,	0,	0,	0,	0,	0,	0,	0,	0,	0,	0,	0,	0,	0,	0],
[0,	0,	0,	0,	0,	0,	99,0,	0,	0,	0,	0,	0,	0,	0,	0,	0,	0,	0,	0,	0,	0,	0,	0,	0,	0,	0,	0,	0,	0,	0,	0,	0,	0,	0,	0,	0,	0,	0,	0,	0,	0,	0,	0,	0,	0,	0,	0],
[0,	0,	0,	0,	0,	0,	1002,	0,	0,	0,	0,	0,	0,	0,	0,	0,	0,	0,	0,	0,	0,	0,	0,	0,	0,	0,	0,	0,	0,	0,	0,	0,	0,	0,	0,	0,	0,	0,	0,	0,	0,	0,	0,	0,	101,102,0,	0],
[0,	101,0,	0,	0,	0,	0,	0,	0,	0,	0,	0,	0,	101,0,	0,	0,	101,0,	0,	0,	0,	24,	0,	0,	0,	0,	101,0,	0,	0,	101,0,	0,	0,	0,	0,	101,0,	0,	0,	0,	0,	0,	0,	101,0,	0],
[0,	0,	0,	0,	0,	0,	0,	0,	0,	101,0,	0,	0,	0,	0,	0,	0,	0,	0,	0,	0,	0,	0,	0,	0,	0,	0,	0,	0,	101,0,	0,	0,	101,0,	301,0,	0,	0,	0,	0,	0,	0,	0,	0,	0,	0,	0],
[0,	0,	101,0,	0,	0,	0,	0,	0,	0,	0,	0,	0,	0,	0,	0,	0,	0,	0,	0,	101,0,	101,0,	0,	0,	102,0,	0,	0,	0,	0,	0,	0,	0,	0,	0,	0,	0,	0,	0,	0,	0,	0,	0,	0,	0,	0],
[0,	0,	0,	0,	0,	0,	0,	0,	0,	0,	0,	0,	301,0,	0,	0,	0,	0,	0,	0,	0,	0,	0,	0,	0,	0,	0,	0,	0,	101,0,	0,	0,	0,	0,	0,	0,	0,	0,	0,	0,	0,	0,	0,	0,	0,	0,	0],
[0,	0,	0,	0,	0,	0,	0,	101,0,	0,	301,0,	0,	0,	0,	102,0,	0,	0,	0,	0,	0,	0,	0,	0,	0,	0,	0,	0,	0,	0,	0,	0,	0,	0,	0,	0,	101,0,  101,0,	0,	0,	101,0,	0,	0,	0],
[0,	0,	0,	0,	0,	0,	0,	0,	0,	0,	0,	0,	0,	0,	0,	0,	0,	0,	0,	0,	0,	0,	0,	0,	0,	0,	0,	0,	0,	0,	0,	101,0,	0,	0,	0,	301,0,	0,	0,	0,	0,	0,	0,	0,	101,0,	0],
[0,	0,	0,	0,	0,	0,	0,	0,	0,	0,	0,	0,	101,0,	0,	0,	0,	0,	301,0,	0,	0,	0,	0,	0,	0,	301,101,0,	0,	0,	0,	0,	0,	0,	0,	0,	0,	0,	0,	0,	0,	0,	0,	0,	0,	0,	0],
[0,	0,	0,	0,	0,	101,0,	0,	0,	0,	0,	0,	0,	0,	0,	0,	0,	0,	0,	0,	0,	0,	101,0,	0,	0,	0,	0,	0,	0,	0,	0,	0,	0,	0,	0,	0,	301,0,	0,	0,	0,	0,	0,	0,	0,	0,	0],
[0,	0,	0,	0,	0,	0,	0,	0,	0,	0,	0,	0,	0,	0,	0,	301,0,	0,	0,	0,	0,	0,	0,	0,	0,	0,	0,	0,	0,	0,	0,	0,	0,	101,0,	0,	0,	0,	0,	0,	101,0,	0,	301,0,	0,	0,	0],
[0,	0,	0,	0,	0,	0,	0,	0,	0,	0,	0,	0,	0,	0,	0,	0,	0,	0,	0,	0,	0,	0,	301,0,	0,	0,	0,	0,	0,	0,	0,	0,	0,	0,	0,	0,	0,	0,	0,	0,	0,	0,	0,	0,	0,	0,	0,	0],
[0,	0,	0,	0,	0,	0,	0,	0,	0,	0,	0,	0,	0,	0,	0,	0,	0,	0,	0,	0,	0,	0,	0,	0,	0,	101,0,	0,	0,	0,	0,	0,	0,	0,	0,	0,	0,	0,	0,	0,	0,	0,	0,	0,	0,	0,	0,	0],
[0,	0,	101,0,	0,	0,	0,	0,	0,	0,	0,	0,	0,	101,0,	0,	0,	0,	0,	0,	101,0,	0,	0,	0,	0,	0,	301,0,	0,	101,0,	0,	0,	0,	0,	101,0,	0,	0,	0,	0,	0,	0,	0,	0,	0,	0],
[0,	0,	0,	0,	0,	0,	0,	0,	0,	0,	0,	101,0,	0,	0,	0,	0,	0,	0,	0,	0,	0,	101,0,	0,	0,	0,	0,	0,	0,	0,	0,	0,	0,	0,	0,	0,	0,	0,	0,	0,	0,	0,  521,0,	101,0,	0],
[0,	0,	0,	0,	0,	0,	0,	301,0,	0,	0,	0,	0,	0,	0,	0,	101,0,	0,	0,	0,	0,	0,	0,	0,	0,	0,	0,	0,	0,	0,	0,	0,	0,	0,	0,	0,	0,	0,	0,	0,	0,	0,	0,	0,	0,	0,	0],
[0,	0,	0,	0,	0,	0,	0,	0,	0,	0,	0,	0,	0,	0,	0,	0,	0,	0,	0,	0,	0,	0,	0,	0,	0,	301,0,	0,	0,	0,	0,	0,	101,0,	0,	0,	0,	0,	0,	101,0,	0,	0,	0,	0,	0,	0,	0],
[0,	0,	0,	0,	0,	101,0,	0,	0,	0,	0,	0,	0,	301,0,	0,	0,	0,	0,	0,	0,	0,	0,	0,	0,	0,	0,	0,	0,	0,	0,	0,	0,	0,	0,	101,0,	0,	0,	0,	0,	0,	0,	0,	0,	0,	0,	0],
[0,	0,	0,	0,	0,	301,0,	0,	101,0,	0,	0,	0,	0,	0,	0,	0,	101,0,	0,	0,	101,0,	0,	0,	0,	0,	0,	0,	0,	0,	0,	0,	0,	0,	0,	0,	0,	0,	0,	0,	0,	0,	0,	0,	0,	0,	0],
[0,	0,	0,	0,	0,	0,	0,	0,	0,	301,0,	0,	0,	101,0,	0,	0,	0,	0,	0,	0,	0,	0,	0,	0,	0,	0,	0,	0,	0,	0,	0,	0,	0,	0,	0,	0,	0,	0,	0,	0,	0,	0,	0,	0,	0,	0,	0],
[0,	0,	0,	0,	0,	0,	0,	0,	0,	0,	0,	0,	0,	0,	0,	0,	0,	0,	0,	102,0,	0,	0,	0,	0,	0,	101,0,	0,	0,	0,	0,	0,	0,	0,	101,0,	0,	0,	0,	0,	0,	101,0,	101,0,	0,	0],
[0,	0,	0,	0,	0,	0,	101,0,	0,	0,	0,	0,	0,	0,	0,	0,	0,	0,	0,	0,	0,	0,	0,	0,	0,	301,0,	0,	0,	101,0,	0,	0,	0,	0,	0,	0,	0,	0,	0,	0,	0,	0,	0,	0,	0,	0,	0],
[0,	0,	0,	0,	0,	0,	0,	0,	0,	0,	0,	0,	0,	0,	0,	0,	0,	0,	0,	0,	0,	0,	101,0,	101,0,	0,	0,	0,	0,	0,	0,	0,	0,	0,	0,	0,	0,	0,	0,	0,	0,	0,	0,	0,	0,	0,	0],
[0,	0,	0,	0,	0,	0,	0,	0,	0,	0,	0,	0,	0,	0,	101,0,	0,	0,	1002,101,0,	0,	0,	0,	0,	0,	0,	0,	0,	0,	0,	0,	0,	0,	0,	0,	0,	0,	0,	101,0,	0,	0,	0,	0,	0,	0,	0],
[0,	0,	0,	0,	0,	0,	0,	0,	0,	101,0,	0,	0,	0,	0,	0,	0,	0,	0,	0,	0,	0,	0,	0,	0,	0,	0,	0,	0,  101,0,	102,0,	0,	0,	0,	0,	0,	0,	0,	0,	0,	0,	0,	0,	0,	0,	0],
[0,	0,	0,	0,	0,	0,	0,	0,	0,	0,	0,	0,	0,	0,	0,	0,	0,	101,0,	0,	0,	0,	0,	0,	0,	0,	0,	0,	0,	0,	0,	0,	0,	0,	0,	0,	0,	0,	0,	0,	0,	0,	0,	0,	0,	0,	0,	0],
[0,	101,101,0,	0,	0,	0,	0,	0,	0,	0,	0,	0,	0,	0,	0,	0,	0,	0,	0,	0,	0,	0,	0,	0,	0,	0,	0,	0,	0,	0,	0,	0,	0,	101,0,	0,	0,	0,	0,	0,	0,	101,0,	0,	0,	0,	0],
[0,	0,	0,	0,	0,	0,	0,	0,	0,	0,	0,	0,	0,	0,	0,	0,	0,	0,	0,	0,	0,	0,	0,	0,	101,0,	0,	0,	0,	0,	0,	0,	0,	0,	0,	0,	301,0,	0,	0,	0,	0,	0,	0,	0,	0,	0,	0],
[0,	0,	0,	0,	301,0,	0,	0,	0,	0,	0,	101,0,	0,	0,	0,	0,	0,	0,	0,	0,	0,	0,	0,	0,	0,	0,	0,	0,	0,	0,	0,	0,	0,	0,	0,	0,	0,	0,	0,	0,	0,	0,	0,	0,	0,	0,	0],
[0,	0,	0,	0,	0,	0,	0,	0,	0,	0,	0,	0,	0,	0,	0,	0,	0,	0,	0,	0,	0,	0,	0,	0,	0,	0,	0,	0,	0,	0,	0,	0,	0,	0,	0,	0,	0,	101,0,	0,	0,	0,	0,	0,	0,	0,	0,	0],
[0,	0,	0,	0,	0,	0,	0,	0,	0,	0,	0,	0,	0,	0,	0,	0,	0,	0,	0,	0,	0,	0,	0,	0,	0,	0,	0,	0,	0,	0,	0,	0,	0,	0,	301,0,	0,	0,	0,	0,	0,	0,	0,	0,	0,	101,0,	0],
[0,	0,	0,	0,	0,	0,	0,	0,	0,	0,	0,	0,	0,	0,	0,	202,202,202,0,	0,	0,	0,	0,	0,	0,	0,	0,	0,	0,	0,	0,	0,	0,	0,	0,	0,	0,	0,	0,	0,	0,	0,	0,	0,	0,	0,	0,	0],
[0,	0,	0,	0,	0,	0,	0,	0,	0,	0,	0,	0,	101,101,101,101,101,101,101,101,0,	0,	0,	0,	0,	0,	0,	0,	0,	0,	0,	0,	0,	0,	0,	0,	0,	0,	0,	0,	0,	101,0,	0,	0,	0,	0,	0],
[0,	0,	0,	0,	0,	0,	0,	0,	0,	0,	0,	0,	0,	0,	0,	0,	0,	0,	0,	0,	0,	0,	0,	0,	0,	0,	0,	0,	0,	101,0,	0,	0,	1001,0,	0,	0,	0,	0,	0,	0,	0,	301,0,	0,	0,	0,	0],
[0,	0,	0,	0,	0,	0,	0,	0,	0,	0,	0,	0,	0,	0,	0,	0,	0,	0,	0,	0,	0,	0,	0,	0,	0,	0,	0,	0,	0,	0,	0,	0,	0,	0,	0,	0,	0,	0,	0,	0,	0,	0,	0,	0,	0,	0,	0,	0],
[0,	0,	101,0,	0,	1002,0,	0,	0,	101,0,	0,	0,	0,	0,	0,	0,	0,	0,	0,	0,	0,	0,	0,	0,	101,0,	0,	0,	0,	0,	0,	0,	0,	0,	0,	0,	0,	0,	0,	0,	0,	0,	0,	0,	0,	0,	0],
[0,	0,	0,	0,	0,	101,0,	520,0,	0,	0,	102,0,	0,	0,	0,	0,	0,	0,	101,0,	0,	0,	0,	0,	519,0,	0,	101,101,0,	0,	0,	0,	0,	0,	0,	0,	0,	0,	0,	0,	0,	101,0,	0,	0,	0],
[0,	0,	0,	0,	0,	0,	0,	0,	0,	0,	0,	0,	0,	0,	301,0,	0,	101,0,	0,	0,	0,	0,	0,	0,	0,	0,	0,	0,	0,	0,	0,	0,	0,	0,	0,	0,	0,	0,	0,	0,	0,	0,	0,	0,	0,	0,	0],
[0,	0,	0,	0,	0,	0,	0,	0,	0,	0,	0,	0,	0,	0,	0,	0,	0,	0,	0,	0,	0,	0,	0,	0,	0,	0,	0,	0,	0,	0,	0,	0,	0,	0,	0,	0,	0,	101,0,	0,	0,	0,	0,	0,	0,	0,	0,	0],
[0,	101,0,	0,	0,	0,	0,	0,	0,	0,	0,	0,	0,	0,	0,	0,	0,	0,	0,	0,	0,	0,	0,	0,	0,	301,0,	0,	0,	101,0,	0,	0,	0,	0,	0,	0,	0,	0,	0,	0,	0,	0,	0,	0,	0,	0,	0],
[0,	0,	0,	0,	0,	0,	0,	0,	0,	0,	0,	0,	0,	0,	0,	0,	0,	0,	0,	301,0,	0,	0,	101,0,	0,	0,	0,	0,	0,	0,	0,	0,	0,	0,	0,	0,	0,	0,	0,	0,	0,	0,	0,	0,	101,0,	0],
[0,	0,	0,	0,	101,0,	0,	101,0,	0,	0,	1001,0,	0,	0,	0,	101,0,	0,	0,	101,0,	0,	0,	0,	0,	0,	0,	0,	0,	1001,0,	0,	0,	0,	101,0,	0,	0,	0,	0,	101,0,	0,	0,	102,0,	0],
[0,	0,	0,	0,	0,	0,	0,	0,	0,	0,	0,	0,	0,	0,	0,	0,	0,	0,	0,	0,	0,	0,	0,	0,	0,	0,	0,	0,	0,	0,	0,	0,	0,	0,	0,	0,	0,	0,	0,	0,	0,	0,	0,	0,	0,	0,	0,	0],
[0,	0,	0,	0,	0,	0,	0,	0,	0,	0,	0,	0,	0,	0,	0,	0,	0,	0,	0,	0,	0,	0,	0,	0,	0,	0,	0,	0,	0,	0,	0,	0,	0,	0,	0,	0,	0,	0,	0,	0,	0,	0,	0,	0,	0,	0,	0,	0]
]
]
}