{

"type":"map",
"cols": 48,
"rows": 49,
"totalLayers": 2,
"tSize": 64,
"playerLayer": 1,

"tiles":
[
[1,	1,	1,	1,	1,	1,	1,	1,	1,	1,	1,	1,	1,	1,	1,	1,	1,	1,	1,	1,	1,	1,	1,	1,	1,	1,	1,	1,	1,	1,	1,	1,	1,	1,	1,	1,	1,	1,	1,	1,	1,	1,	1,	1,	1,	1,	1,	1],
[1,	0,	0,	0,	0,	0,	0,	0,	0,	0,	0,	0,	0,	0,	0,	0,	0,	1,	1,	0,	0,	1,	0,	0,	0,	0,	0,	0,	0,	0,	0,	0,	1,	1,	1,	1,	1,	1,	1,	1,	1,	0,	0,	0,	0,	0,	1,	1],
[1,	1,	1,	0,	0,	0,	0,	0,	0,	0,	0,	0,	0,	0,	0,	0,	0,	1,	1,	0,	0,	1,	0,	0,	0,	1,	0,	0,	0,	0,	1,	0,	1,	1,	1,	1,	1,	1,	1,	1,	1,	0,	0,	0,	0,	0,	1,	1],
[1,	1,	1,	0,	1,	1,	1,	0,	0,	1,	1,	0,	1,	1,	1,	1,	1,	1,	1,	0,	0,	1,	1,	1,	1,	1,	0,	1,	1,	1,	1,	0,	1,	0,	0,	0,	0,	0,	0,	0,	1,	0,	0,	0,	1,	1,	1,	1],
[1,	1,	1,	0,	1,	1,	1,	0,	0,	1,	1,	0,	1,	1,	1,	1,	1,	1,	1,	0,	0,	0,	0,	0,	0,	0,	0,	0,	0,	0,	0,	0,	0,	0,	0,	0,	0,	0,	0,	0,	1,	0,	1,	1,	0,	0,	1,	1],
[1,	1,	1,	0,	0,	1,	1,	0,	0,	1,	1,	0,	0,	1,	1,	1,	1,	1,	1,	1,	1,	1,	1,	0,	0,	0,	0,	0,	0,	0,	0,	0,	0,	0,	1,	1,	0,	1,	1,	0,	1,	1,	1,	0,	1,	0,	1,	1],
[1,	1,	1,	0,	0,	1,	1,	0,	0,	1,	1,	0,	0,	0,	0,	0,	0,	0,	0,	0,	1,	1,	1,	1,	1,	1,	1,	1,	1,	1,	1,	1,	1,	0,	1,	1,	0,	1,	1,	0,	1,	1,	1,	1,	1,	0,	1,	1],
[1,	1,	1,	0,	0,	1,	1,	1,	0,	1,	1,	0,	1,	1,	0,	0,	0,	0,	0,	0,	1,	0,	0,	0,	0,	1,	1,	1,	1,	1,	1,	1,	1,	0,	1,	1,	0,	0,	0,	0,	1,	1,	1,	0,	1,	0,	1,	1],
[1,	1,	1,	0,	0,	1,	0,	0,	0,	0,	0,	0,	1,	1,	1,	1,	1,	1,	1,	0,	1,	0,	1,	0,	0,	1,	1,	1,	0,	0,	0,	0,	1,	0,	1,	1,	1,	1,	1,	0,	1,	1,	1,	0,	0,	0,	1,	1],
[1,	1,	1,	0,	0,	0,	0,	0,	0,	0,	0,	0,	1,	1,	1,	1,	1,	0,	0,	0,	1,	0,	1,	1,	0,	0,	0,	0,	0,	1,	1,	0,	1,	0,	1,	1,	1,	1,	1,	0,	1,	1,	1,	0,	1,	1,	1,	1],
[1,	1,	0,	0,	1,	1,	1,	1,	0,	1,	1,	1,	1,	1,	0,	0,	0,	0,	1,	1,	1,	0,	0,	1,	0,	1,	1,	0,	0,	1,	1,	0,	1,	0,	0,	0,	0,	0,	0,	0,	1,	0,	0,	0,	1,	1,	1,	1],
[1,	1,	0,	0,	1,	1,	1,	1,	0,	0,	1,	1,	1,	1,	0,	1,	0,	0,	0,	0,	0,	0,	1,	1,	0,	1,	1,	0,	0,	1,	1,	0,	1,	0,	0,	1,	0,	1,	1,	1,	1,	0,	1,	0,	0,	1,	1,	1],
[1,	1,	0,	0,	0,	0,	0,	1,	0,	0,	1,	1,	1,	1,	0,	1,	1,	1,	1,	1,	1,	1,	1,	1,	0,	1,	1,	0,	0,	1,	1,	0,	1,	0,	0,	1,	0,	1,	1,	1,	1,	0,	1,	0,	0,	0,	1,	1],
[1,	1,	0,	1,	1,	1,	0,	1,	0,	0,	1,	0,	0,	1,	0,	0,	1,	1,	1,	1,	1,	1,	1,	1,	0,	1,	1,	0,	0,	1,	1,	0,	1,	0,	0,	1,	0,	1,	1,	1,	1,	0,	1,	1,	1,	0,	1,	1],
[1,	1,	0,	1,	1,	1,	0,	1,	0,	0,	0,	0,	0,	1,	0,	0,	1,	1,	1,	1,	1,	0,	1,	0,	0,	1,	1,	1,	0,	1,	1,	0,	1,	0,	0,	1,	0,	0,	0,	0,	1,	0,	1,	0,	0,	0,	1,	1],
[1,	1,	0,	0,	0,	1,	0,	0,	1,	0,	0,	1,	0,	1,	0,	0,	1,	1,	1,	0,	0,	0,	0,	0,	0,	0,	0,	1,	0,	1,	0,	0,	1,	0,	0,	1,	1,	1,	1,	0,	1,	0,	1,	0,	0,	1,	1,	1],
[1,	1,	1,	1,	0,	1,	0,	0,	1,	1,	0,	1,	0,	1,	0,	0,	1,	1,	1,	0,	0,	1,	1,	1,	1,	1,	0,	1,	0,	0,	0,	0,	1,	1,	0,	0,	0,	1,	1,	0,	1,	0,	0,	0,	1,	1,	1,	1],
[1,	1,	1,	0,	0,	1,	0,	0,	1,	1,	0,	1,	0,	1,	0,	0,	1,	1,	1,	0,	0,	1,	1,	1,	1,	1,	0,	1,	1,	0,	0,	0,	1,	1,	0,	1,	0,	1,	1,	0,	1,	1,	1,	0,	0,	0,	1,	1],
[1,	1,	1,	0,	0,	1,	0,	0,	1,	1,	0,	1,	0,	0,	0,	0,	0,	0,	1,	0,	0,	1,	1,	1,	1,	1,	0,	1,	1,	0,	0,	1,	1,	1,	0,	1,	0,	0,	0,	0,	1,	1,	1,	0,	1,	0,	1,	1],
[1,	1,	1,	0,	0,	1,	0,	1,	1,	1,	0,	1,	1,	1,	1,	1,	0,	0,	1,	0,	0,	1,	1,	1,	1,	1,	0,	1,	1,	0,	0,	0,	1,	1,	0,	1,	0,	0,	1,	1,	1,	1,	1,	1,	1,	0,	1,	1],
[1,	0,	0,	0,	0,	1,	0,	0,	0,	0,	0,	0,	1,	1,	1,	1,	0,	0,	1,	1,	0,	0,	0,	0,	0,	0,	0,	0,	0,	0,	1,	0,	1,	1,	0,	1,	0,	0,	1,	0,	0,	0,	0,	0,	1,	0,	1,	1],
[1,	0,	0,	0,	1,	1,	1,	1,	1,	1,	0,	0,	1,	1,	1,	1,	0,	0,	0,	0,	1,	1,	0,	0,	1,	1,	1,	1,	0,	1,	1,	0,	0,	0,	0,	1,	0,	1,	1,	0,	1,	1,	1,	0,	1,	0,	1,	1],
[1,	0,	1,	1,	1,	1,	1,	1,	1,	1,	0,	0,	1,	1,	0,	0,	0,	1,	0,	0,	1,	1,	0,	0,	1,	1,	1,	1,	0,	1,	1,	0,	0,	1,	1,	1,	0,	1,	1,	0,	1,	1,	0,	0,	1,	0,	1,	1],
[1,	0,	1,	1,	1,	1,	1,	1,	1,	1,	0,	0,	1,	1,	0,	1,	1,	1,	0,	0,	1,	1,	0,	0,	1,	1,	1,	1,	0,	1,	1,	1,	1,	1,	1,	1,	0,	1,	1,	0,	1,	1,	1,	0,	0,	0,	1,	1],
[1,	0,	0,	0,	0,	0,	0,	0,	1,	1,	0,	0,	1,	1,	0,	1,	1,	1,	0,	0,	1,	1,	0,	0,	1,	1,	1,	1,	0,	0,	0,	0,	0,	1,	1,	1,	0,	1,	0,	0,	0,	0,	0,	0,	1,	1,	1,	1],
[1,	0,	0,	0,	1,	1,	1,	0,	0,	1,	0,	0,	1,	1,	0,	1,	1,	1,	0,	0,	1,	1,	0,	0,	1,	0,	1,	1,	0,	1,	1,	1,	0,	1,	1,	1,	0,	1,	0,	1,	1,	1,	0,	1,	1,	1,	1,	1],
[1,	0,	0,	0,	0,	1,	1,	0,	0,	1,	0,	0,	1,	1,	0,	0,	1,	1,	0,	0,	1,	1,	0,	0,	1,	0,	0,	0,	0,	1,	1,	1,	0,	1,	1,	1,	0,	1,	0,	1,	1,	1,	0,	1,	1,	1,	1,	1],
[1,	0,	1,	1,	0,	0,	1,	0,	0,	1,	0,	0,	1,	1,	0,	0,	1,	1,	0,	0,	0,	1,	0,	0,	1,	0,	1,	0,	0,	0,	0,	1,	0,	1,	0,	1,	0,	1,	0,	1,	1,	1,	0,	1,	1,	1,	1,	1],
[1,	0,	1,	0,	1,	0,	1,	0,	0,	1,	0,	0,	1,	1,	0,	0,	1,	1,	1,	1,	0,	1,	0,	0,	1,	0,	1,	1,	1,	0,	0,	1,	0,	1,	0,	1,	0,	1,	0,	0,	0,	0,	0,	1,	1,	1,	1,	1],
[1,	0,	1,	0,	0,	0,	1,	0,	0,	1,	0,	0,	1,	1,	0,	0,	1,	1,	1,	1,	0,	0,	0,	0,	0,	0,	1,	1,	1,	1,	0,	1,	1,	1,	0,	1,	0,	0,	0,	0,	0,	0,	1,	1,	1,	1,	1,	1],
[1,	0,	1,	0,	1,	1,	1,	0,	0,	1,	0,	0,	1,	1,	0,	0,	1,	1,	1,	1,	0,	1,	1,	1,	1,	1,	1,	1,	1,	1,	0,	1,	1,	0,	0,	1,	0,	1,	1,	1,	1,	1,	1,	1,	1,	1,	1,	1],
[1,	0,	1,	0,	1,	1,	1,	0,	0,	1,	0,	0,	0,	0,	0,	0,	0,	0,	0,	0,	0,	1,	1,	1,	1,	1,	1,	1,	1,	1,	0,	0,	1,	0,	0,	0,	0,	1,	1,	1,	1,	1,	0,	0,	0,	0,	1,	1],
[1,	0,	1,	0,	0,	0,	0,	0,	0,	1,	0,	1,	1,	1,	1,	1,	0,	1,	1,	1,	1,	1,	1,	1,	1,	1,	0,	1,	0,	1,	0,	0,	0,	0,	1,	1,	1,	1,	1,	1,	1,	1,	0,	0,	0,	0,	1,	1],
[1,	0,	1,	1,	1,	1,	0,	1,	0,	0,	0,	1,	1,	1,	1,	1,	0,	1,	1,	1,	1,	1,	1,	1,	1,	1,	0,	1,	0,	1,	0,	1,	1,	0,	1,	1,	1,	1,	1,	0,	0,	1,	0,	0,	0,	0,	1,	1],
[1,	0,	0,	0,	0,	1,	0,	1,	1,	1,	1,	1,	1,	1,	1,	1,	0,	1,	0,	1,	1,	1,	1,	0,	0,	0,	0,	1,	0,	1,	0,	1,	1,	0,	1,	1,	1,	1,	1,	0,	0,	1,	0,	0,	0,	0,	1,	1],
[1,	0,	1,	1,	0,	1,	0,	1,	1,	1,	1,	1,	1,	1,	1,	1,	0,	0,	0,	0,	0,	1,	1,	0,	1,	1,	0,	1,	1,	1,	0,	1,	1,	0,	1,	1,	1,	1,	1,	0,	0,	1,	1,	1,	0,	0,	1,	1],
[1,	0,	1,	1,	0,	1,	0,	1,	1,	1,	1,	1,	1,	1,	1,	1,	0,	0,	1,	1,	0,	0,	0,	0,	1,	1,	0,	1,	1,	1,	0,	1,	1,	0,	1,	1,	1,	1,	1,	0,	0,	1,	1,	1,	0,	0,	1,	1],
[1,	0,	1,	1,	0,	1,	0,	1,	0,	0,	0,	0,	0,	1,	1,	1,	1,	0,	0,	1,	0,	0,	0,	0,	1,	0,	0,	0,	1,	1,	0,	1,	1,	0,	0,	0,	0,	0,	0,	0,	0,	1,	1,	1,	0,	0,	1,	1],
[1,	0,	0,	0,	0,	1,	0,	0,	0,	1,	1,	0,	0,	1,	1,	1,	1,	0,	0,	1,	1,	1,	0,	1,	1,	0,	1,	1,	1,	1,	0,	0,	1,	1,	1,	1,	1,	1,	1,	0,	0,	1,	1,	1,	0,	0,	1,	1],
[1,	1,	1,	1,	0,	1,	1,	1,	0,	1,	1,	0,	0,	1,	1,	1,	1,	0,	0,	1,	1,	1,	0,	1,	1,	0,	1,	1,	1,	1,	1,	0,	1,	0,	0,	0,	0,	0,	0,	0,	0,	1,	1,	1,	0,	0,	1,	1],
[1,	1,	1,	1,	0,	1,	1,	1,	0,	1,	1,	0,	0,	0,	0,	0,	0,	0,	0,	1,	1,	1,	0,	0,	1,	0,	1,	1,	1,	1,	1,	0,	1,	0,	1,	1,	1,	1,	1,	0,	0,	1,	1,	1,	0,	1,	1,	1],
[1,	0,	0,	1,	0,	0,	0,	1,	0,	1,	1,	1,	1,	1,	1,	1,	1,	0,	1,	1,	1,	1,	0,	0,	1,	0,	1,	1,	1,	1,	1,	0,	1,	0,	1,	1,	1,	1,	1,	0,	0,	1,	1,	1,	0,	1,	1,	1],
[1,	0,	0,	1,	0,	1,	0,	1,	0,	0,	0,	1,	1,	1,	0,	1,	1,	0,	0,	0,	0,	0,	0,	0,	1,	0,	0,	0,	0,	0,	0,	0,	1,	0,	1,	1,	1,	1,	1,	0,	0,	0,	0,	0,	0,	0,	1,	1],
[1,	0,	0,	1,	0,	1,	0,	1,	0,	1,	1,	0,	0,	0,	0,	0,	0,	0,	0,	1,	1,	1,	0,	0,	1,	0,	0,	1,	1,	1,	0,	1,	1,	0,	1,	1,	1,	1,	1,	0,	0,	0,	0,	0,	1,	0,	1,	1],
[1,	1,	0,	1,	1,	1,	0,	1,	0,	0,	0,	0,	1,	0,	1,	1,	1,	1,	1,	1,	1,	1,	0,	0,	1,	0,	0,	1,	1,	1,	0,	1,	1,	0,	1,	1,	1,	1,	1,	1,	1,	1,	1,	0,	1,	0,	1,	1],
[1,	0,	0,	0,	0,	0,	0,	1,	1,	1,	1,	1,	1,	0,	1,	1,	1,	0,	0,	0,	0,	0,	0,	1,	1,	0,	0,	0,	0,	1,	0,	1,	1,	0,	1,	1,	1,	1,	1,	1,	1,	1,	1,	1,	0,	0,	1,	1],
[1,	1,	1,	1,	1,	1,	0,	0,	0,	0,	0,	0,	0,	0,	1,	1,	1,	0,	0,	0,	0,	0,	0,	0,	0,	0,	1,	1,	1,	1,	0,	0,	0,	0,	1,	1,	1,	1,	1,	1,	1,	1,	1,	1,	1,	1,	1,	1],
[1,	1,	1,	1,	1,	1,	1,	1,	1,	1,	1,	1,	1,	1,	1,	1,	1,	1,	1,	1,	1,	1,	1,	1,	1,	1,	1,	1,	1,	1,	1,	1,	1,	1,	1,	1,	1,	1,	1,	1,	1,	1,	1,	1,	1,	1,	1,	1],
[1,	1,	1,	1,	1,	1,	1,	1,	1,	1,	1,	1,	1,	1,	1,	1,	1,	1,	1,	1,	1,	1,	1,	1,	1,	1,	1,	1,	1,	1,	1,	1,	1,	1,	1,	1,	1,	1,	1,	1,	1,	1,	1,	1,	1,	1,	1,	1]
],
"layers":
[[
[741,	741,	741,	741,	741,	741,	741,	741,	741,	741,	741,	741,	741,	741,	741,	741,	741,	741,	741,	741,	741,	741,	741,	741,	741,	741,	741,	741,	741,	741,	741,	741,	741,	741,	741,	741,	741,	741,	741,	741,	741,	741,	741,	741,	741,	741,	741,	741],
[741,	725,	725,	725,	725,	725,	725,	725,	725,	725,	725,	725,	725,	725,	725,	725,	725,	741,	741,	725,	725,	741,	725,	725,	725,	725,	725,	725,	725,	725,	725,	725,	741,	741,	741,	741,	741,	741,	741,	741,	741,	725,	725,	725,	725,	725,	741,	741],
[741,	741,	741,	725,	725,	725,	725,	725,	725,	725,	725,	725,	725,	725,	725,	725,	725,	741,	741,	725,	725,	741,	725,	725,	725,	741,	725,	725,	725,	725,	741,	725,	741,	741,	741,	741,	741,	741,	741,	741,	741,	725,	725,	725,	725,	725,	741,	741],
[741,	741,	741,	725,	741,	741,	741,	725,	725,	741,	741,	725,	741,	741,	741,	741,	741,	741,	741,	725,	725,	741,	741,	741,	741,	741,	725,	741,	741,	741,	741,	725,	741,	725,	725,	725,	725,	725,	725,	725,	741,	725,	725,	725,	741,	741,	741,	741],
[741,	741,	741,	725,	741,	741,	741,	725,	725,	741,	741,	725,	741,	741,	741,	741,	741,	741,	741,	725,	725,	725,	725,	725,	725,	725,	725,	725,	725,	725,	725,	725,	725,	725,	725,	725,	725,	725,	725,	725,	741,	725,	741,	725,	725,	725,	741,	741],
[741,	741,	741,	725,	725,	741,	741,	725,	725,	741,	741,	725,	725,	741,	741,	741,	741,	741,	741,	741,	741,	741,	741,	725,	725,	725,	725,	725,	725,	725,	725,	725,	725,	725,	741,	741,	725,	741,	741,	725,	741,	741,	741,	725,	741,	725,	741,	741],
[741,	741,	741,	725,	725,	741,	741,	725,	725,	741,	741,	725,	725,	725,	725,	725,	725,	725,	725,	725,	741,	741,	741,	741,	741,	741,	741,	741,	741,	741,	741,	741,	741,	725,	741,	741,	725,	741,	741,	725,	741,	741,	741,	741,	741,	725,	741,	741],
[741,	741,	741,	725,	725,	741,	741,	741,	725,	741,	741,	725,	741,	741,	725,	725,	725,	725,	725,	725,	741,	725,	725,	725,	725,	741,	741,	741,	741,	741,	741,	741,	741,	725,	741,	741,	725,	725,	725,	725,	741,	741,	741,	725,	741,	725,	741,	741],
[741,	741,	741,	725,	725,	741,	725,	741,	725,	725,	725,	725,	741,	741,	741,	741,	741,	741,	741,	725,	741,	725,	741,	725,	725,	741,	741,	741,	725,	725,	725,	725,	741,	725,	741,	741,	741,	741,	741,	725,	741,	741,	741,	725,	725,	725,	741,	741],
[741,	741,	741,	725,	725,	725,	725,	725,	725,	725,	725,	725,	741,	741,	741,	741,	741,	725,	725,	725,	741,	725,	741,	741,	725,	725,	725,	725,	725,	741,	741,	725,	741,	725,	741,	741,	741,	741,	741,	725,	741,	741,	741,	725,	741,	741,	741,	741],
[741,	741,	725,	725,	741,	741,	741,	741,	725,	741,	741,	741,	741,	741,	725,	725,	725,	725,	741,	741,	741,	725,	725,	741,	725,	741,	741,	725,	725,	741,	741,	725,	741,	725,	725,	725,	725,	725,	725,	725,	741,	725,	725,	725,	741,	741,	741,	741],
[741,	741,	725,	725,	741,	741,	741,	741,	725,	725,	741,	741,	741,	741,	725,	741,	725,	725,	725,	725,	725,	725,	741,	741,	725,	741,	741,	725,	725,	741,	741,	725,	741,	725,	725,	741,	725,	741,	741,	741,	741,	725,	741,	725,	725,	741,	741,	741],
[741,	741,	725,	725,	725,	725,	725,	741,	725,	725,	741,	741,	741,	741,	725,	741,	741,	741,	741,	741,	741,	741,	741,	741,	725,	741,	741,	725,	725,	741,	741,	725,	741,	725,	725,	741,	725,	741,	741,	741,	741,	725,	741,	725,	725,	725,	741,	741],
[741,	741,	725,	741,	741,	741,	725,	741,	725,	725,	741,	725,	725,	741,	725,	725,	741,	741,	741,	741,	741,	741,	741,	741,	725,	741,	741,	725,	725,	741,	741,	725,	741,	725,	725,	741,	725,	741,	741,	741,	741,	725,	741,	741,	741,	725,	741,	741],
[741,	741,	725,	741,	741,	741,	725,	741,	725,	725,	725,	725,	725,	741,	725,	725,	741,	741,	741,	741,	741,	725,	741,	725,	725,	741,	741,	741,	725,	741,	741,	725,	741,	725,	725,	741,	725,	725,	725,	725,	741,	725,	741,	725,	725,	725,	741,	741],
[741,	741,	725,	725,	725,	741,	725,	725,	741,	725,	725,	741,	725,	741,	725,	725,	741,	741,	741,	725,	725,	725,	725,	725,	725,	725,	725,	741,	725,	741,	725,	725,	741,	725,	725,	741,	741,	741,	741,	725,	741,	725,	741,	725,	725,	741,	741,	741],
[741,	741,	741,	741,	725,	741,	725,	725,	741,	741,	725,	741,	725,	741,	725,	725,	741,	741,	741,	725,	725,	741,	741,	741,	741,	741,	725,	741,	725,	725,	725,	725,	741,	741,	725,	725,	725,	741,	741,	725,	741,	725,	725,	725,	741,	741,	741,	741],
[741,	741,	741,	725,	725,	741,	725,	725,	741,	741,	725,	741,	725,	741,	725,	725,	741,	741,	741,	725,	725,	741,	741,	741,	741,	741,	725,	741,	741,	725,	725,	725,	741,	741,	725,	741,	725,	741,	741,	725,	741,	741,	741,	725,	725,	725,	741,	741],
[741,	741,	741,	725,	725,	741,	725,	725,	741,	741,	725,	741,	725,	725,	725,	725,	725,	725,	741,	725,	725,	741,	741,	741,	741,	741,	725,	741,	741,	725,	725,	741,	741,	741,	725,	741,	725,	725,	725,	725,	741,	741,	741,	725,	741,	725,	741,	741],
[741,	741,	741,	725,	725,	741,	725,	741,	741,	741,	725,	741,	741,	741,	741,	741,	725,	725,	741,	725,	725,	741,	741,	741,	741,	741,	725,	741,	741,	725,	725,	725,	741,	741,	725,	741,	725,	725,	741,	741,	741,	741,	741,	741,	741,	725,	741,	741],
[741,	725,	725,	725,	725,	741,	725,	725,	725,	725,	725,	725,	741,	741,	741,	741,	725,	725,	741,	741,	725,	725,	725,	725,	725,	725,	725,	725,	725,	725,	741,	725,	741,	741,	725,	741,	725,	725,	741,	725,	725,	725,	725,	725,	741,	725,	741,	741],
[741,	725,	725,	725,	741,	741,	741,	741,	741,	741,	725,	725,	741,	741,	741,	741,	725,	725,	725,	725,	741,	741,	725,	725,	741,	741,	741,	741,	725,	741,	741,	725,	725,	725,	725,	741,	725,	741,	741,	725,	741,	741,	741,	725,	741,	725,	741,	741],
[741,	725,	741,	741,	741,	741,	741,	741,	741,	741,	725,	725,	741,	741,	725,	725,	725,	741,	725,	725,	741,	741,	725,	725,	741,	741,	741,	741,	725,	741,	741,	725,	725,	741,	741,	741,	725,	741,	741,	725,	741,	741,	725,	725,	741,	725,	741,	741],
[741,	725,	741,	741,	741,	741,	741,	741,	741,	741,	725,	725,	741,	741,	725,	741,	741,	741,	725,	725,	741,	741,	725,	725,	741,	741,	741,	741,	725,	741,	741,	741,	741,	741,	741,	741,	725,	741,	741,	725,	741,	741,	741,	725,	725,	725,	741,	741],
[741,	725,	725,	725,	725,	725,	725,	725,	741,	741,	725,	725,	741,	741,	725,	741,	741,	741,	725,	725,	741,	741,	725,	725,	741,	741,	741,	741,	725,	725,	725,	725,	725,	741,	741,	741,	725,	741,	725,	725,	725,	725,	725,	725,	741,	741,	741,	741],
[741,	725,	725,	725,	741,	741,	741,	725,	725,	741,	725,	725,	741,	741,	725,	741,	741,	741,	725,	725,	741,	741,	725,	725,	741,	725,	741,	741,	725,	741,	741,	741,	725,	741,	741,	741,	725,	741,	725,	741,	741,	741,	725,	741,	741,	741,	741,	741],
[741,	725,	725,	725,	725,	741,	741,	725,	725,	741,	725,	725,	741,	741,	725,	725,	741,	741,	725,	725,	741,	741,	725,	725,	741,	725,	725,	725,	725,	741,	741,	741,	725,	741,	741,	741,	725,	741,	725,	741,	741,	741,	725,	741,	741,	741,	741,	741],
[741,	725,	741,	741,	725,	725,	741,	725,	725,	741,	725,	725,	741,	741,	725,	725,	741,	741,	725,	725,	725,	741,	725,	725,	741,	725,	741,	725,	725,	725,	725,	741,	725,	741,	725,	741,	725,	741,	725,	741,	741,	741,	725,	741,	741,	741,	741,	741],
[741,	725,	741,	725,	741,	725,	741,	725,	725,	741,	725,	725,	741,	741,	725,	725,	741,	741,	741,	741,	725,	741,	725,	725,	741,	725,	741,	741,	741,	725,	725,	741,	725,	741,	725,	741,	725,	741,	725,	725,	725,	725,	725,	741,	741,	741,	741,	741],
[741,	725,	741,	725,	725,	725,	741,	725,	725,	741,	725,	725,	741,	741,	725,	725,	741,	741,	741,	741,	725,	725,	725,	725,	725,	725,	741,	741,	741,	741,	725,	741,	741,	741,	725,	741,	725,	725,	725,	725,	725,	725,	741,	741,	741,	741,	741,	741],
[741,	725,	741,	725,	741,	741,	741,	725,	725,	741,	725,	725,	741,	741,	725,	725,	741,	741,	741,	741,	725,	741,	741,	741,	741,	741,	741,	741,	741,	741,	725,	741,	741,	725,	725,	741,	725,	741,	741,	741,	741,	741,	741,	741,	741,	741,	741,	741],
[741,	725,	741,	725,	741,	741,	741,	725,	725,	741,	725,	725,	725,	725,	725,	725,	725,	725,	725,	725,	725,	741,	741,	741,	741,	741,	741,	741,	741,	741,	725,	725,	741,	725,	725,	725,	725,	741,	741,	741,	741,	741,	725,	725,	725,	725,	741,	741],
[741,	725,	741,	725,	725,	725,	725,	725,	725,	741,	725,	741,	741,	741,	741,	741,	725,	741,	741,	741,	741,	741,	741,	741,	741,	741,	725,	741,	725,	741,	725,	725,	725,	725,	741,	741,	741,	741,	741,	741,	741,	741,	725,	725,	725,	725,	741,	741],
[741,	725,	741,	741,	741,	741,	725,	741,	725,	725,	725,	741,	741,	741,	741,	741,	725,	741,	741,	741,	741,	741,	741,	741,	741,	741,	725,	741,	725,	741,	725,	741,	741,	725,	741,	741,	741,	741,	741,	725,	725,	741,	725,	725,	725,	725,	741,	741],
[741,	725,	725,	725,	725,	741,	725,	741,	741,	741,	741,	741,	741,	741,	741,	741,	725,	741,	725,	741,	741,	741,	741,	725,	725,	725,	725,	741,	725,	741,	725,	741,	741,	725,	741,	741,	741,	741,	741,	725,	725,	741,	725,	725,	725,	725,	741,	741],
[741,	725,	741,	741,	725,	741,	725,	741,	741,	741,	741,	741,	741,	741,	741,	741,	725,	725,	725,	725,	725,	741,	741,	725,	741,	741,	725,	741,	741,	741,	725,	741,	741,	725,	741,	741,	741,	741,	741,	725,	725,	741,	741,	741,	725,	725,	741,	741],
[741,	725,	741,	741,	725,	741,	725,	741,	741,	741,	741,	741,	741,	741,	741,	741,	725,	725,	741,	741,	725,	725,	725,	725,	741,	741,	725,	741,	741,	741,	725,	741,	741,	725,	741,	741,	741,	741,	741,	725,	725,	741,	741,	741,	725,	725,	741,	741],
[741,	725,	741,	741,	725,	741,	725,	741,	725,	725,	725,	725,	725,	741,	741,	741,	741,	725,	725,	741,	725,	725,	725,	725,	741,	725,	725,	725,	741,	741,	725,	741,	741,	725,	725,	725,	725,	725,	725,	725,	725,	741,	741,	741,	725,	725,	741,	741],
[741,	725,	725,	725,	725,	741,	725,	725,	725,	741,	741,	725,	725,	741,	741,	741,	741,	725,	725,	741,	741,	741,	725,	741,	741,	725,	741,	741,	741,	741,	725,	725,	741,	741,	741,	741,	741,	741,	741,	725,	725,	741,	741,	741,	725,	725,	741,	741],
[741,	741,	741,	741,	725,	741,	741,	741,	725,	741,	741,	725,	725,	741,	741,	741,	741,	725,	725,	741,	741,	741,	725,	741,	741,	725,	741,	741,	741,	741,	741,	725,	741,	725,	725,	725,	725,	725,	725,	725,	725,	741,	741,	741,	725,	725,	741,	741],
[741,	741,	741,	741,	725,	741,	741,	741,	725,	741,	741,	725,	725,	725,	725,	725,	725,	725,	725,	741,	741,	741,	725,	725,	741,	725,	741,	741,	741,	741,	741,	725,	741,	725,	741,	741,	741,	741,	741,	725,	725,	741,	741,	741,	725,	741,	741,	741],
[741,	725,	725,	741,	725,	725,	725,	741,	725,	741,	741,	741,	741,	741,	741,	741,	741,	725,	741,	741,	741,	741,	725,	725,	741,	725,	741,	741,	741,	741,	741,	725,	741,	725,	741,	741,	741,	741,	741,	725,	725,	741,	741,	741,	725,	741,	741,	741],
[741,	725,	725,	741,	725,	741,	725,	741,	725,	725,	725,	741,	741,	741,	725,	741,	741,	725,	725,	725,	725,	725,	725,	725,	741,	725,	725,	725,	725,	725,	725,	725,	741,	725,	741,	741,	741,	741,	741,	725,	725,	725,	725,	725,	725,	725,	741,	741],
[741,	725,	725,	741,	725,	741,	725,	741,	725,	741,	741,	725,	725,	725,	725,	725,	725,	725,	725,	741,	741,	741,	725,	725,	741,	725,	725,	741,	741,	741,	725,	741,	741,	725,	741,	741,	741,	741,	741,	725,	725,	725,	725,	725,	741,	725,	741,	741],
[741,	741,	725,	741,	741,	741,	725,	741,	725,	725,	725,	725,	741,	725,	741,	741,	741,	741,	741,	741,	741,	741,	725,	725,	741,	725,	725,	741,	741,	741,	725,	741,	741,	725,	741,	741,	741,	741,	741,	741,	741,	741,	741,	725,	741,	725,	741,	741],
[741,	725,	725,	725,	725,	725,	725,	741,	741,	741,	741,	741,	741,	725,	741,	741,	741,	725,	725,	725,	725,	725,	725,	741,	741,	725,	725,	725,	725,	741,	725,	741,	741,	725,	741,	741,	741,	741,	741,	741,	741,	741,	741,	741,	725,	725,	741,	741],
[741,	741,	741,	741,	741,	741,	725,	725,	725,	725,	725,	725,	725,	725,	741,	741,	741,	725,	725,	725,	725,	725,	725,	725,	725,	725,	741,	741,	741,	741,	725,	725,	725,	725,	741,	741,	741,	741,	741,	741,	741,	741,	741,	741,	741,	741,	741,	741],
[741,	741,	741,	741,	741,	741,	741,	741,	741,	741,	741,	741,	741,	741,	741,	741,	741,	741,	741,	741,	741,	741,	741,	741,	741,	741,	741,	741,	741,	741,	741,	741,	741,	741,	741,	741,	741,	741,	741,	741,	741,	741,	741,	741,	741,	741,	741,	741],
[741,	741,	741,	741,	741,	741,	741,	741,	741,	741,	741,	741,	741,	741,	741,	741,	741,	741,	741,	741,	741,	741,	741,	741,	741,	741,	741,	741,	741,	741,	741,	741,	741,	741,	741,	741,	741,	741,	741,	741,	741,	741,	741,	741,	741,	741,	741,	741]
]
,[
[0,	0,	0,	0,	0,	0,	0,	0,	0,	0,	0,	0,	0,	0,	0,	0,	0,	0,	0,	0,	0,	0,	0,	0,	0,	0,	0,	0,	0,	0,	0,	0,	0,	0,	0,	0,	0,	0,	0,	0,	0,	0,	0,	0,	0,	0,	0,	0],
[0,	101,0,	0,	0,	301,0,	0,	0,	0,	0,	0,	0,	301,	0,	0,	101,	0,	0,	101,	0,	0,	101,	0,	0,	0,	102,	0,	0,	0,	0,	101,	0,	0,	0,	0,	0,	0,	0,	0,	0,	102,	0,	0,	0,	101,	0,	0],
[0,	0,	0,	0,	0,	0,	0,	301,0,	0,	101,	0,	0,	0,	0,	0,	0,	0,	0,	0,	0,	0,	0,	0,	101,	0,	0,	0,	0,	0,	0,	0,	0,	0,	0,	0,	0,	0,	0,	0,	0,	0,	0,	301,	0,	0,	0,	0],
[0,	0,	0,	0,	0,	0,	0,	0,	0,	0,	0,	0,	0,	0,	0,	0,	0,	0,	0,	0,	0,	7,	0,	0,	0,	0,	0,	0,	0,	0,	0,	0,	7,	0,	0,	301,	0,	0,	0,	101,	0,	0,	0,	0,	0,	7,	0,	0],
[0,	0,	0,	0,	0,	0,	0,	0,	0,	0,	0,	0,	0,	0,	0,	0,	0,	0,	0,	0,	101,	0,	0,	101,	0,	0,	101,	301,	0,	0,	0,	0,	0,	0,	0,	0,	0,	0,	0,	0,	0,	101,	0,	1002,	0,	0,	0,	0],
[0,	0,	0,	0,	101,	0,	0,	0,	0,	0,	0,	0,	0,	0,	0,	0,	0,	0,	0,	0,	0,	0,	0,	0,	0,	301,	0,	0,	0,	301,	0,	0,	301,	0,	0,	0,	0,	0,	0,	0,	0,	0,	0,	99,	0,	0,	0,	0],
[0,	0,	0,	0,	0,	0,	0,	0,	101,	0,	0,	0,	0,	101,	0,	301,	0,	0,	0,	0,	0,	0,	0,	0,	202,0,	0,	0, 202,	0,	0,	0,	0,	0,	0,	0,	0,	0,	0,	0,	0,	0,	0,	0,	0,	0,	0,	0],
[0,	0,	0,	0,	0,	0,	0,	0,	0,	0,	0,	0,	0,	0,	0,	0,	0,	0,	0,	0,	0,	101,	0,	0,	0,	0,	0,	0, 202, 0,	0,	0,	0,	0,	0,	0,	0,	0,	0,	0,	0,	0,	0,	101,	0,	0,	0,	0],
[0,	0,	0,	301,	0,	0,	0,	7,	0,	0,	0,	0,	0,	0,	0,	0,	0,	0,	0,	0,	0,	0,	0,	101,	0,	0,	0,	0,	0,	0,	0,	101,	0,	0,	0,	0,	0,	0,	0,	0,	0,	0,	0,	0,	0,	0,	0,	0],
[0,	0,	0,	0,	0,	0,	0,	0,	0,	301,	0,	0,	0,	0,	0,	0,	7,	0,	0,	0,	0,	0,	0,	0,	0,	0,	101,	0,	0,	0,	0,	0,	0,	0,	7,	0,	0,	0,	0,	101,	0,	0,	0,	0,	0,	0,	0,	0],
[0,	0,	101,	0,	0,	0,	0,	0,	0,	0,	0,	0,	0,	0,	101,	0,	0,	0,	0,	0,	0,	0,	0,	0,	0,	0,	0,	0,	0,	0,	0,	0,	0,	0,	101,	0,	0,	0,	0,	0,	0,	0,	0,	0,	0,	0,	0,	0],
[0,	0,	0,	0,	0,	0,	0,	0,	0,	0,	0,	0,	0,	0,	0,	0,	0,	0,	101,	0,	0,	0,	0,	0,	0,	0,	0,	0,	0,	0,	0,	0,	0,	0,	0,	0,	0,	0,	0,	0,	0,	0,	0,	0,	0,	0,	0,	0],
[0,	0,	0,	0,	0,	0,	101,	0,	0,	0,	0,	0,	0,	0,	0,	0,	0,	0,	0,	0,	0,	0,	0,	0,	0,	0,	0,	0,	0,	0,	0,	0,	0,	0,	0,	0,	0,	0,	0,	0,	0,	0,	0,	0,	0,	0,	0,	0],
[0,	0,	0,	7,	0,	0,	0,	0,	301,	0,	0,	0,	101,	0,	0,	0,	0,	0,	0,	0,	0,	0,	0,	7,	0,	0,	0,	102,	0,	0,	0,	0,	0,	0,	0,	0,	0,	0,	0,	0,	0,	0,	0,	0,	0,	0,	0,	0],
[0,	0,	0,	7,	0,	0,	0,	0,	0,	0,	0,	0,	0,	0,	301,	0,	0,	0,	0,	0,	7,	101,	0,	0,	0,	0,	0,	0,	0,	0,	0,	0,	0,	0,	0,	0,	0,	0,	0,	0,	0,	0,	0,	0,	0,	101,	0,	0],
[0,	0,	0,	0,	0,	0,	0,	0,	0,	301,	0,	7,	0,	0,	0,	0,	0,	0,	0,	101,	0,	0,	0,	0,	0,	0,	101,	0,	0,	7,	0,	0,	0,	101,	0,	0,	7,	0,	0,	0,	0,	0,	0,	0,	0,	0,	0,	0],
[0,	0,	0,	0,	0,	0,	0,	0,	0,	0,	0,	0,	0,	0,	0,	0,	0,	0,	0,	0,	0,	0,	0,	0,	0,	0,	0,	0,	0,	0,	0,	301,	0,	0,	0,	0,	0,	0,	0,	0,	0,	101,	0,	0,	0,	0,	0,	0],
[0,	0,	0,	0,	0,	0,	301,	0,	0,	0,	0,	0,	0,	0,	0,	0,	7,	0,	0,	0,	301,	0,	0,	0,	0,	0,	0,	0,	0,	0,	0,	0,	0,	0,	0,	0,	0,	0,	0,	0,	0,	0,	0,	0,	0,	0,	0,	0],
[0,	0,	0,	0,	0,	0,	0,	0,	0,	0,	0,	0,	0,	0,	0,	0,	0,	0,	0,	0,	0,	0,	0,	0,	0,	0,	0,	0,	0,	0,	301,	0,	0,	0,	0,	0,	0,	0,	0,	101,	0,	0,	0,	0,	0,	0,	0,	0],
[0,	0,	0,	0,	0,	0,	0,	0,	0,	0,	0,	0,	0,	0,	0,	0,	0,	0,	0,	0,	0,	7,	0,	0,	0,	0,	0,	0,	0,	0,	0,	0,	0,	0,	0,	0,	0,	0,	0,	0,	0,	0,	0,	0,	0,	0,	0,	0],
[0,	101,	0,	0,	101,	0,	0,	0,	0,	0,	0,	101,	0,	0,	0,	0,	0,	0,	0,	0,	101,0,	0,	0,	0,	0,	0,	0,	0,	101,	0,	0,	0,	0,	0,	0,	0,	0,	0,	0,	0,	0,	0,	0,	0,	0,	0,	0],
[0,	0,	0,	0,	0,	0,	0,	0,	0,	0,	0,	0,	0,	0,	0,	0,	0,	0,	0,	0,	0,	0,	0,	301,0,	0,	0,	0,	0,	0,	0,	0,	0,	0,	101,	0,	0,	0,	0,	0,	0,	0,	0,	0,	0,	0,	0,	0],
[0,	0,	0,	0,	0,	0,	0,	0,	0,	0,	0,	0,	0,	0,	101,	0,	0,	0,	0,	0,	0,	0,	0,	0,	0,	0,	0,	0,	0,	0,	0,	0,	0,	0,	0,	0,	0,	0,	0,	0,	0,	0,	101,	0,	0,	0,	0,	0],
[0,	0,	0,	0,	0,	0,	0,	0,	0,	0,	301,	0,	0,	0,	0,	0,	0,	0,	301,0,	0,	0,	301,0,	0,	0,	0,	0,	0,	0,	0,	0,	0,	0,	0,	0,	0,	0,	0,	0,	0,	0,	0,	0,	0,	0,	0,	0],
[0,	0,	0,	0,	0,	0,	0,	101,	0,	0,	0,	0,	0,	0,	0,	0,	0,	0,	0,	0,	0,	0,	0,	0,	0,	0,	0,	0,	0,	0,	0,	0,	0,	0,	0,	0,	0,	0,	101,	0,	0,	0,	0,	0,	0,	0,	0,	0],
[0,	0,	301,	0,	0,	0,	0,	0,	0,	0,	0,	0,	0,	0,	0,	0,	0,	0,	0,	0,	0,	0,	0,	101,	0,	0,	7,	0,	0,	0,	0,	0,	0,	0,	0,	0,	0,	0,	0,	0,	0,	0,	0,	0,	0,	0,	0,	0],
[0,	0,	0,	0,	0,	0,	0,	0,	0,	0,	101,	0,	0,	0,	0,	0,	0,	0,	0,	0,	0,	0,	0,	0,	0,	0,	0,	0,	0,	0,	0,	0,	0,	0,	0,	0,	0,	0,	0,	0,	0,	0,	0,	0,	0,	0,	0,	0],
[0,	0,	0,	0,	0,	0,	0,	0,	0,	0,	0,	0,	0,	0,	0,	0,	0,	0,	101,	0,	0,	0,	0,	301,	0,	0,	0,	0,	0,	0,	101,	0,	0,	0,	0,	0,	0,	0,	0,	0,	0,	0,	0,	0,	0,	0,	0,	0],
[0,	0,	0,	0,	0,	0,	0,	301,	0,	0,	0,	0,	0,	0,	301,	0,	0,	0,	0,	0,	0,	0,	0,	0,	0,	0,	0,	0,	0,	0,	0,	0,	0,	0,	0,	0,	0,	7,	0,	0,	0,	0,	101,	0,	0,	0,	0,	0],
[0,	0,	0,	0,	101,	0,	0,	0,	0,	0,	0,	0,	0,	0,	0,	0,	0,	0,	0,	0,	0,	0,	0,	0,	0,	101,	0,	0,	0,	0,	0,	0,	0,	7,	0,	0,	0,	1002,0,	0,	0,	0,	0,	0,	0,	0,	0,	0],
[0,	0,	0,	0,	0,	0,	0,	0,	301,	0,	0,	301,	0,	0,	0,	0,	7,	0,	0,	7,	0,	0,	0,	0,	0,	0,	0,	0,	0,	0,	0,	0,	0,	101,	0,	0,	0,	0,	0,	0,	0,	0,	0,	0,	0,	0,	0,	0],
[0,	0,	0,	0,	0,	0,	0,	0,	0,	0,	0,	0,	0,	0,	101,	0,	0,	0,	0,	0,	101,	0,	0,	0,	0,	0,	0,	0,	0,	0,	0,	301,	0,	0,	0,	0,	101,	0,	0,	0,	0,	0,	102,	0,	0,	101,	0,	0],
[0,	0,	0,	0,	0,	0,	0,	0,	0,	0,	0,	0,	0,	0,	0,	0,	0,	0,	0,	0,	0,	0,	0,	0,	0,	0,	0,	0,	0,	0,	0,	0,	0,	0,	0,	0,	0,	0,	0,	0,	0,	0,	0,	0,	0,	0,	0,	0],
[0,	0,	0,	7,	7,	0,	0,	7,	0,	0,	101,	0,	0,	0,	0,	0,	0,	0,	0,	0,	0,	0,	0,	0,	0,	0,	0,	202,102,202,0,	0,	0,	0,	0,	0,	0,	0,	0,	101,	0,	0,	0,	0,	301,	0,	0,	0],
[0,	0,	0,	0,	101,	0,	0,	0,	0,	0,	0,	0,	0,	0,	0,	0,	0,	0,	101,	0,	0,	0,	0,	0,	0,	0,	0,	0,	0,	0,	0,	0,	0,	0,	0,	0,	0,	0,	0,	0,	0,	0,	101,	0,	0,	0,	0,	0],
[0,	0,	0,	0,	0,	0,	0,	0,	0,	0,	0,	0,	0,	0,	0,	0,	0,	0,	0,	0,	0,	0,	0,	0,	0,	0,	0,	0,	7,	0,	0,	0,	0,	0,	0,	0,	0,	0,	0,	0,	0,	0,	0,	0,	0,	0,	0,	0],
[0,	0,	0,	0,	0,	0,	0,	0,	0,	0,	0,	0,	0,	0,	0,	0,	101,	0,	0,	0,	0,	0,	0,	0,	0,	0,	0,	0,	0,	0,	0,	0,	0,	0,	0,	0,	0,	0,	0,	0,	0,	0,	0,	0,	301,	0,	0,	0],
[0,	0,	0,	0,	0,	0,	0,	7,	101,	0,	0,	0,	0,	0,	0,	0,	0,	0,	0,	0,	0,	0,	0,	101,	0,	0,	0,	101,	0,	0,	0,	0,	0,	101,	0,	0,	0,	0,	0,	0,	0,	0,	0,	0,	0,	0,	0,	0],
[0,	101,	0,	0,	0,	0,	0,	0,	0,	0,	0,	0,	301,	0,	0,	0,	0,	0,	0,	0,	0,	0,	0,	0,	0,	0,	0,	0,	0,	0,	0,	0,	0,	0,	0,	0,	0,	0,	0,	301,	0,	0,	0,	0,	0,	0,	0,	0],
[0,	0,	0,	0,	0,	0,	0,	0,	0,	0,	0,	0,	0,	0,	0,	0,	0,	301,	0,	0,	0,	0,	0,	0,	0,	0,	0,	0,	0,	0,	0,	0,	0,	0,	0,	0,	0,	0,	0,	0,	0,	0,	0,	0,	0,	1001,	0,	0],
[0,	0,	0,	0,	0,	0,	0,	0,	0,	0,	0,	101,	0,	0,	0,	0,	0,	0,	0,	0,	0,	0,	0,	0,	0,	0,	0,	0,	0,	0,	0,	0,	0,	0,	0,	0,	0,	0,	0,	0,	0,	0,	0,	0,	0,	0,	0,	0],
[0,	0,	0,	0,	0,	0,	101,	0,	0,	0,	0,	0,	0,	0,	0,	0,	0,	0,	0,	0,	0,	0,	0,	0,	0,	101,	0,	0,	0,	0,	0,	0,	0,	0,	0,	0,	0,	0,	0,	0,	0,	0,	0,	0,	0,	0,	0,	0],
[0,	0,	0,	0,	0,	0,	0,	0,	0,	0,	0,	0,	0,	0,	0,	0,	7,	0,	0,	0,	0,	0,	0,	0,	0,	0,	0,	0,	0,	0,	0,	0,	0,	0,	0,	0,	0,	0,	0,	0,	0,	0,	0,	0,	0,	0,	0,	0],
[0,	0,	0,	0,	0,	0,	0,	0,	0,	0,	0,	0,	0,	0,	0,	101,	0,	0,	101,	0,	0,	0,	0,	301,	0,	0,	0,	7,	0,	0,	5000,	0,	0,	0,	0,	0,	0,	0,	0,	0,	101,0,	301,0,	7, 0,	0,	0],
[0,	0,	0,	0,	0,	0,	0,	0,	0,	0,	0,	0,	7,	0,	0,	0,	0,	0,	0,	0,	0,	7,	0,	0,	0,	301,	0,	7,	0,	0,	0,	0,	0,	0,	0,	0,	0,	0,	0,	0,	0,	0,	0,	0,	7,	0,	0,	0],
[0,	101,	0,	0,	0,	0,	0,	0,	0,	0,	0,	0,	7,	0,	0,	0,	0,	0,	0,	0,	301,	0,	0,	0,	0,	0,	0,	0,	101,	0,	0,	0,	0,	0,	0,	0,	0,	0,	0,	0,	0,	0,	0,	0,	101,	101,	0,	0],
[0,	0,	0,	0,	0,	0,	1001,	0,	0,	0,	0,	0,	0,	0,	0,	0,	0,	101,	0,	0,	0,	0,	0,	101,	0,	0,	0,	0,	0,	0,	0,	0,	0,	101,	0,	0,	0,	0,	0,	0,	0,	0,	0,	0,	0,	0,	0,	0],
[0,	0,	0,	0,	0,	0,	0,	0,	0,	0,	0,	0,	0,	0,	0,	0,	0,	0,	0,	0,	0,	0,	0,	0,	0,	0,	0,	0,	0,	0,	0,	0,	0,	7,	0,	0,	0,	0,	0,	0,	0,	0,	0,	0,	0,	0,	0,	0],
[0,	0,	0,	0,	0,	0,	0,	0,	0,	0,	0,	0,	0,	0,	0,	0,	0,	0,	0,	0,	0,	0,	0,	0,	0,	0,	0,	0,	0,	0,	0,	0,	0,	0,	0,	0,	0,	0,	0,	0,	0,	0,	0,	0,	0,	0,	0,	0]
]
]
}